0 25 25 25 25 25 25 25 25 25 25 25 25 25 25 25 25 0 0 0 0 0 0 0 0 0 0 0 -8 -8 -8 -8 -8 -8 -8 -8 -8 -8 -8 -8 -8 -8 -8 -8 -8 -8 0 0 0 0 0 0 0 0 0 0 0 0 0 0 0 0 0 0
41 25 25 25 25 25 25 25 25 25 25 25 25 25 25 25 25 25 0 0 0 0 0 0 0 0 0 -8 -8 -8 -8 -8 -8 -8 -8 -8 -8 -8 -8 -8 -8 -8 -8 -8 -8 -8 0 0 0 0 0 0 0 0 0 0 0 0 0 0 0 0 0 0
42 25 25 25 25 25 25 25 25 25 25 25 25 25 25 25 25 0 0 0 0 0 0 0 0 0 0 0 -8 -8 -8 -8 -8 -8 -8 -8 -8 -8 -8 -8 -8 -8 -8 -8 -8 -8 0 0 0 0 0 0 0 0 0 0 0 0 0 0 0 0 0 0
57 25 25 25 25 25 25 25 25 25 25 25 25 25 25 25 25 0 0 25 0 0 0 0 0 0 0 0 -8 -8 -8 -8 -8 -8 -8 -8 -8 -8 -8 -8 -8 -8 -8 -8 -8 -8 0 0 0 0 0 0 0 0 0 0 0 0 0 0 0 0 0 0
63 25 25 25 25 25 25 25 25 25 25 25 25 25 25 25 25 0 0 0 0 0 0 0 0 0 0 0 -8 -8 -8 -8 -8 -8 -8 -8 -8 -8 -8 -8 -8 -8 -8 -8 -8 -8 0 0 0 0 0 0 0 0 0 0 0 0 0 0 0 0 0 0
84 25 25 25 25 25 25 25 25 25 0 25 25 25 25 25 25 0 0 0 0 0 0 0 0 0 0 0 -8 -8 -8 -8 -8 -8 -8 -8 -8 -8 -8 -8 -8 -8 -8 -8 -8 -8 0 0 0 0 0 0 0 0 0 0 0 0 0 0 0 0 0 0
87 25 25 25 25 25 25 25 25 25 0 25 25 25 25 25 25 25 0 0 0 0 0 0 0 0 0 0 -8 -8 -8 -8 -8 -8 -8 -8 -8 -8 -8 -8 -8 -8 -8 -8 -8 -8 0 0 0 0 0 0 0 0 0 0 0 0 0 0 0 0 0 0
89 25 25 25 25 25 25 25 25 25 0 0 25 25 25 25 25 25 0 0 0 0 0 0 0 0 0 0 -8 -8 -8 -8 -8 -8 -8 -8 -8 -8 -8 -8 -8 -8 -8 -8 -8 -8 0 0 0 0 0 0 0 0 0 0 0 0 0 0 0 0 0 0
111 25 25 25 25 25 25 25 25 25 0 0 25 25 25 25 25 0 0 0 0 0 0 0 0 0 0 0 -8 -8 -8 -8 -8 -8 -8 -8 -8 -8 -8 -8 -8 -8 -8 -8 -8 -8 0 0 0 0 0 0 0 0 0 0 0 0 0 0 0 0 0 0
115 25 25 25 25 25 25 25 25 25 0 25 25 25 25 25 25 0 0 0 0 0 0 0 0 0 -8 0 -8 -8 -8 -8 -8 -8 -8 -8 -8 -8 -8 -8 -8 -8 -8 -8 -8 -8 0 0 0 0 0 0 0 0 0 0 0 0 0 0 0 0 0 0
120 25 25 25 25 25 25 25 25 25 25 25 25 25 25 25 25 0 0 0 0 0 0 0 0 0 -8 -8 -8 -8 -8 -8 -8 -8 -8 -8 -8 -8 -8 -8 -8 -8 -8 -8 -8 -8 0 0 0 0 0 0 0 0 0 0 0 0 0 0 0 0 0 0
125 25 25 25 25 25 25 25 25 25 25 25 25 25 25 25 25 0 0 0 0 0 0 0 0 0 -8 0 -8 -8 -8 -8 -8 -8 -8 -8 -8 -8 -8 -8 -8 -8 -8 -8 -8 -8 0 0 0 0 0 0 0 0 0 0 0 0 0 0 0 0 0 0
127 25 25 25 25 25 25 25 25 25 25 25 25 25 25 25 25 0 0 0 0 0 0 0 0 0 0 0 -8 -8 -8 -8 -8 -8 -8 -8 -8 -8 -8 -8 -8 -8 -8 -8 -8 -8 0 0 0 0 0 0 0 0 0 0 0 0 0 0 0 0 0 0
130 25 25 25 25 25 25 25 25 25 0 25 25 25 25 25 25 0 0 0 0 0 0 0 0 0 0 0 -8 -8 -8 -8 -8 -8 -8 -8 -8 -8 -8 -8 -8 -8 -8 -8 -8 -8 0 0 0 0 0 0 0 0 0 0 0 0 0 0 0 0 0 0
138 25 25 25 25 25 25 25 25 25 0 25 25 25 25 25 25 0 0 0 0 0 0 -8 0 0 0 0 -8 -8 -8 -8 -8 -8 -8 -8 -8 -8 -8 -8 -8 -8 -8 -8 -8 -8 0 0 0 0 0 0 0 0 0 0 0 0 0 0 0 0 0 0
150 25 25 25 25 25 25 25 25 25 25 25 25 25 25 25 25 0 0 0 0 0 0 -8 0 0 0 0 -8 -8 -8 -8 -8 -8 -8 -8 -8 -8 -8 -8 -8 -8 -8 -8 -8 -8 0 0 0 0 0 0 0 0 0 0 0 0 0 0 0 0 0 0
152 25 25 25 25 25 25 25 25 25 25 25 25 25 25 25 25 0 0 0 0 0 0 0 0 0 0 0 -8 -8 -8 -8 -8 -8 -8 -8 -8 -8 -8 -8 -8 -8 -8 -8 -8 -8 0 0 0 0 0 0 0 0 0 0 0 0 0 0 0 0 0 0
155 25 25 25 25 25 25 25 25 25 25 25 25 25 25 25 25 0 0 0 0 0 0 0 0 -8 0 0 -8 -8 -8 -8 -8 -8 -8 -8 -8 -8 -8 -8 -8 -8 -8 -8 -8 -8 0 0 0 0 0 0 0 0 0 0 0 0 0 0 0 0 0 0
166 25 25 25 25 25 25 25 25 25 25 25 25 25 25 25 25 0 0 0 0 0 0 0 0 0 0 0 -8 -8 -8 -8 -8 -8 -8 -8 -8 -8 -8 -8 -8 -8 -8 -8 -8 -8 0 0 0 0 0 0 0 0 0 0 0 0 0 0 0 0 0 0
169 25 25 25 25 25 25 25 25 25 25 25 25 25 25 25 25 25 0 0 0 0 0 0 0 0 0 0 -8 -8 -8 -8 -8 -8 -8 -8 -8 -8 -8 -8 -8 -8 -8 -8 -8 -8 0 0 0 0 0 0 0 0 0 0 0 0 0 0 0 0 0 0
175 25 25 25 25 25 25 25 25 25 25 25 25 25 25 25 25 25 25 0 0 0 0 0 0 0 0 0 -8 -8 -8 -8 -8 -8 -8 -8 -8 -8 -8 -8 -8 -8 -8 -8 -8 -8 0 0 0 0 0 0 0 0 0 0 0 0 0 0 0 0 0 0
220 25 25 25 25 25 25 25 25 25 25 25 25 25 0 25 25 25 25 0 0 0 0 -8 0 0 0 0 -8 -8 -8 -8 -8 -8 -8 -8 -8 -8 -8 -8 -8 -8 -8 -8 -8 -8 0 0 0 0 0 0 0 0 0 0 0 0 0 0 0 0 0 0
225 25 25 25 25 25 25 25 25 25 25 25 25 25 0 0 25 25 25 0 0 0 0 -8 0 0 0 0 -8 -8 -8 -8 -8 -8 -8 -8 -8 -8 -8 -8 -8 -8 -8 -8 -8 -8 0 0 0 0 0 0 0 0 0 0 0 0 0 0 0 0 0 0
228 25 25 25 25 25 25 25 25 25 25 25 25 25 0 0 0 25 25 0 0 0 0 -8 0 0 0 0 -8 -8 -8 -8 -8 -8 -8 -8 -8 -8 -8 -8 -8 -8 -8 -8 -8 -8 0 0 0 0 0 0 0 0 0 0 0 0 0 0 0 0 0 0
231 25 25 25 25 25 25 25 25 25 25 25 25 25 0 0 0 0 25 0 0 0 0 -8 0 0 0 0 -8 -8 -8 -8 -8 -8 -8 -8 -8 -8 -8 -8 -8 -8 -8 -8 -8 -8 0 0 0 0 0 0 0 0 0 0 0 0 0 0 0 0 0 0
239 25 25 25 25 25 25 25 25 25 25 25 25 25 0 0 0 0 0 0 0 0 0 -8 0 0 0 0 -8 -8 -8 -8 -8 -8 -8 -8 -8 -8 -8 -8 -8 -8 -8 -8 -8 -8 0 0 0 0 0 0 0 0 0 0 0 0 0 0 0 0 0 0
246 25 25 25 25 25 0 25 25 25 25 25 25 25 0 0 0 0 0 0 0 0 0 -8 0 0 0 0 -8 -8 -8 -8 -8 -8 -8 -8 -8 -8 -8 -8 -8 -8 -8 -8 -8 -8 0 0 0 0 0 0 0 0 0 0 0 0 0 0 0 0 0 0
247 25 25 25 25 25 0 0 25 25 25 25 25 25 0 0 0 0 0 0 0 0 0 -8 0 0 0 0 -8 -8 -8 -8 -8 -8 -8 -8 -8 -8 -8 -8 -8 -8 -8 -8 -8 -8 0 0 0 0 0 0 0 0 0 0 0 0 0 0 0 0 0 0
251 25 25 25 25 25 0 0 0 0 25 25 25 25 0 0 0 0 0 0 0 0 0 -8 0 0 0 0 -8 -8 -8 -8 -8 -8 -8 -8 -8 -8 -8 -8 -8 -8 -8 -8 -8 -8 0 0 0 0 0 0 0 0 0 0 0 0 0 0 0 0 0 0
261 25 25 25 25 25 0 0 0 0 25 25 25 25 0 0 0 0 0 0 0 0 0 0 0 0 0 0 -8 -8 -8 -8 -8 -8 -8 -8 -8 -8 -8 -8 -8 -8 -8 -8 -8 -8 0 0 0 0 0 0 0 0 0 0 0 0 0 0 0 0 0 0
264 25 25 25 25 25 0 0 0 0 25 25 25 25 25 0 0 0 0 0 0 0 0 0 0 0 0 0 -8 -8 -8 -8 -8 -8 -8 -8 -8 -8 -8 -8 -8 -8 -8 -8 -8 -8 0 0 0 0 0 0 0 0 0 0 0 0 0 0 0 0 0 0
270 25 25 25 25 25 0 0 0 0 25 25 25 25 25 0 0 0 0 0 0 0 0 -8 0 0 0 0 -8 -8 -8 -8 -8 -8 -8 -8 -8 -8 -8 -8 -8 -8 -8 -8 -8 -8 0 0 0 0 0 0 0 0 0 0 0 0 0 0 0 0 0 0
278 25 25 25 25 25 25 25 25 25 25 25 25 25 25 0 0 0 0 0 0 0 0 -8 -8 0 0 0 -8 -8 -8 -8 -8 -8 -8 -8 -8 -8 -8 -8 -8 -8 -8 -8 -8 -8 0 0 0 0 0 0 0 0 0 0 0 0 0 0 0 0 0 0
289 25 25 25 25 25 25 25 25 25 25 25 25 25 0 0 0 0 0 0 0 0 0 -8 -8 0 0 0 -8 -8 -8 -8 -8 -8 -8 -8 -8 -8 -8 -8 -8 -8 -8 -8 -8 -8 0 0 0 0 0 0 0 0 0 0 0 0 0 0 0 0 0 0
297 25 25 25 25 25 25 25 25 25 25 25 25 25 0 0 0 0 0 0 0 0 0 -8 0 0 0 0 -8 -8 -8 -8 -8 -8 -8 -8 -8 -8 -8 -8 -8 -8 -8 -8 -8 -8 0 0 0 0 0 0 0 0 0 0 0 0 0 0 0 0 0 0
308 25 25 25 25 25 25 25 25 25 25 25 25 25 0 0 0 0 0 0 0 0 0 0 0 0 0 0 -8 -8 -8 -8 -8 -8 -8 -8 -8 -8 -8 -8 -8 -8 -8 -8 -8 -8 0 0 0 0 0 0 0 0 0 0 0 0 0 0 0 0 0 0
337 25 25 25 25 25 25 25 0 25 25 25 25 25 0 0 0 0 0 0 0 0 0 -8 0 0 0 0 -8 -8 -8 -8 -8 -8 -8 -8 -8 -8 -8 -8 -8 -8 -8 -8 -8 -8 0 0 0 0 0 0 0 0 0 0 0 0 0 0 0 0 0 0
343 25 25 25 25 25 25 25 0 0 25 25 25 25 0 0 0 0 0 0 0 0 0 -8 0 0 0 0 -8 -8 -8 -8 -8 -8 -8 -8 -8 -8 -8 -8 -8 -8 -8 -8 -8 -8 0 0 0 0 0 0 0 0 0 0 0 0 0 0 0 0 0 0
349 25 25 25 25 25 25 0 0 0 25 25 25 25 0 0 0 0 0 0 0 0 0 -8 0 0 0 0 -8 -8 -8 -8 -8 -8 -8 -8 -8 -8 -8 -8 -8 -8 -8 -8 -8 -8 0 0 0 0 0 0 0 0 0 0 0 0 0 0 0 0 0 0
360 25 25 25 25 25 25 0 0 0 25 25 25 25 0 0 0 0 0 0 0 0 0 0 0 0 0 0 -8 -8 -8 -8 -8 -8 -8 -8 -8 -8 -8 -8 -8 -8 -8 -8 -8 -8 0 0 0 0 0 0 0 0 0 0 0 0 0 0 0 0 0 0
373 25 25 25 25 25 25 0 0 0 25 25 25 25 25 0 0 0 0 0 0 0 0 0 0 0 0 0 -8 -8 -8 -8 -8 -8 -8 -8 -8 -8 -8 -8 -8 -8 -8 -8 -8 -8 0 0 0 0 0 0 0 0 0 0 0 0 0 0 0 0 0 0
439 25 25 25 25 25 25 25 0 0 25 25 25 25 25 0 0 0 0 0 0 0 0 0 0 0 0 0 -8 -8 -8 -8 -8 -8 -8 -8 -8 -8 -8 -8 -8 -8 -8 -8 -8 -8 0 0 0 0 0 0 0 0 0 0 0 0 0 0 0 0 0 0
441 25 25 25 25 25 25 25 25 25 25 25 25 25 25 0 0 25 25 0 0 0 0 0 0 0 0 0 -8 -8 -8 -8 -8 -8 -8 -8 -8 -8 -8 -8 -8 -8 -8 -8 -8 -8 0 0 0 0 0 0 0 0 0 0 0 0 0 0 0 0 0 0
460 25 25 25 25 25 25 25 25 25 25 25 25 25 25 0 25 25 25 0 0 0 0 0 0 0 0 0 -8 -8 -8 -8 -8 -8 -8 -8 -8 -8 -8 -8 -8 -8 -8 -8 -8 -8 0 0 0 0 0 0 0 0 0 0 0 0 0 0 0 0 0 0
470 25 25 25 25 25 25 25 25 25 25 25 25 25 25 0 25 25 25 0 0 25 0 0 0 0 0 0 -8 -8 -8 -8 -8 -8 -8 -8 -8 -8 -8 -8 -8 -8 -8 -8 -8 -8 0 0 0 0 0 0 0 0 0 0 0 0 0 0 0 0 0 0
472 25 25 25 25 25 25 25 25 25 25 25 25 25 25 0 25 25 25 0 0 25 0 0 0 0 25 0 -8 -8 -8 -8 -8 -8 -8 -8 -8 -8 -8 -8 -8 -8 -8 -8 -8 -8 0 0 0 0 0 0 0 0 0 0 0 0 0 0 0 0 0 0
475 25 25 25 25 25 25 25 25 25 25 25 25 25 25 0 25 25 25 0 0 25 0 0 0 0 25 25 -8 -8 -8 -8 -8 -8 -8 -8 -8 -8 -8 -8 -8 -8 -8 -8 -8 -8 0 0 0 0 0 0 0 0 0 0 0 0 0 0 0 0 0 0
484 25 25 25 25 25 25 25 25 25 25 25 25 25 25 0 25 25 25 0 25 25 0 0 0 0 25 25 -8 -8 -8 -8 -8 -8 -8 -8 -8 -8 -8 -8 -8 -8 -8 -8 -8 -8 0 0 0 0 0 0 0 0 0 0 0 0 0 0 0 0 0 0
488 25 25 25 25 25 25 25 25 25 25 25 25 25 25 0 25 25 25 0 25 25 25 0 0 0 25 25 -8 -8 -8 -8 -8 -8 -8 -8 -8 -8 -8 -8 -8 -8 -8 -8 -8 -8 0 0 0 0 0 0 0 0 0 0 0 0 0 0 0 0 0 0
489 25 25 25 25 25 25 25 25 25 25 25 25 25 25 0 25 25 25 0 25 25 0 0 0 0 25 25 -8 -8 -8 -8 -8 -8 -8 -8 -8 -8 -8 -8 -8 -8 -8 -8 -8 -8 0 0 0 0 0 0 0 0 0 0 0 0 0 0 0 0 0 0
492 25 25 25 25 25 25 25 25 25 25 25 25 25 25 0 25 25 25 0 25 25 0 0 0 0 0 0 -8 -8 -8 -8 -8 -8 -8 -8 -8 -8 -8 -8 -8 -8 -8 -8 -8 -8 0 0 0 0 0 0 0 0 0 0 0 0 0 0 0 0 0 0
496 25 25 25 25 25 25 25 25 25 25 25 25 25 25 0 25 25 25 0 0 25 0 0 0 0 0 0 -8 -8 -8 -8 -8 -8 -8 -8 -8 -8 -8 -8 -8 -8 -8 -8 -8 -8 0 0 0 0 0 0 0 0 0 0 0 0 0 0 0 0 0 0
497 25 25 25 25 25 25 25 25 25 25 25 25 25 25 0 25 25 25 0 0 0 0 0 0 0 0 0 -8 -8 -8 -8 -8 -8 -8 -8 -8 -8 -8 -8 -8 -8 -8 -8 -8 -8 0 0 0 0 0 0 0 0 0 0 0 0 0 0 0 0 0 0
508 25 25 25 25 25 25 25 25 25 25 25 25 25 25 25 25 25 25 0 0 0 0 0 0 0 0 0 -8 -8 -8 -8 -8 -8 -8 -8 -8 -8 -8 -8 -8 -8 -8 -8 -8 -8 0 0 0 0 0 0 0 0 0 0 0 0 0 0 0 0 0 0
524 25 25 25 25 25 25 25 25 25 25 25 25 25 25 25 25 25 25 0 0 0 0 0 0 0 25 0 -8 -8 -8 -8 -8 -8 -8 -8 -8 -8 -8 -8 -8 -8 -8 -8 -8 -8 0 0 0 0 0 0 0 0 0 0 0 0 0 0 0 0 0 0
526 25 25 25 25 25 25 25 25 25 25 25 25 25 25 25 25 25 25 0 0 0 0 0 0 0 25 25 -8 -8 -8 -8 -8 -8 -8 -8 -8 -8 -8 -8 -8 -8 -8 -8 -8 -8 0 0 0 0 0 0 0 0 0 0 0 0 0 0 0 0 0 0
528 25 25 25 25 25 25 25 25 25 25 25 25 25 25 25 25 25 25 0 0 0 0 0 0 25 25 25 -8 -8 -8 -8 -8 -8 -8 -8 -8 -8 -8 -8 -8 -8 -8 -8 -8 -8 0 0 0 0 0 0 0 0 0 0 0 0 0 0 0 0 0 0
530 25 25 25 25 25 25 25 25 25 25 25 25 25 25 25 25 25 25 0 0 0 0 0 0 0 25 25 -8 -8 -8 -8 -8 -8 -8 -8 -8 -8 -8 -8 -8 -8 -8 -8 -8 -8 0 0 0 0 0 0 0 0 0 0 0 0 0 0 0 0 0 0
532 25 25 25 25 25 25 25 25 25 25 25 25 25 25 25 25 25 25 0 0 0 0 0 0 0 25 0 -8 -8 -8 -8 -8 -8 -8 -8 -8 -8 -8 -8 -8 -8 -8 -8 -8 -8 0 0 0 0 0 0 0 0 0 0 0 0 0 0 0 0 0 0
533 25 25 25 25 25 25 25 25 25 25 25 25 25 25 25 25 25 25 0 0 0 0 0 0 0 0 0 -8 -8 -8 -8 -8 -8 -8 -8 -8 -8 -8 -8 -8 -8 -8 -8 -8 -8 0 0 0 0 0 0 0 0 0 0 0 0 0 0 0 0 0 0
535 25 25 25 25 25 25 25 25 25 25 25 25 25 25 25 25 25 0 0 0 0 0 0 0 0 0 0 -8 -8 -8 -8 -8 -8 -8 -8 -8 -8 -8 -8 -8 -8 -8 -8 -8 -8 0 0 0 0 0 0 0 0 0 0 0 0 0 0 0 0 0 0
536 25 25 25 25 25 25 25 0 0 25 25 25 25 25 25 0 0 0 0 0 0 0 0 0 0 0 0 -8 -8 -8 -8 -8 -8 -8 -8 -8 -8 -8 -8 -8 -8 -8 -8 -8 -8 0 0 0 0 0 0 0 0 0 0 0 0 0 0 0 0 0 0
538 25 25 25 25 25 25 0 0 0 25 25 25 25 25 25 0 0 0 0 0 0 0 0 0 0 0 0 -8 -8 -8 -8 -8 -8 -8 -8 -8 -8 -8 -8 -8 -8 -8 -8 -8 -8 0 0 0 0 0 0 0 0 0 0 0 0 0 0 0 0 0 0
539 25 25 25 25 25 25 0 0 0 25 25 25 25 25 0 0 0 0 0 0 0 0 0 0 0 0 0 -8 -8 -8 -8 -8 -8 -8 -8 -8 -8 -8 -8 -8 -8 -8 -8 -8 -8 0 0 0 0 0 0 0 0 0 0 0 0 0 0 0 0 0 0
561 25 25 25 25 25 25 25 0 0 25 25 25 25 25 0 0 0 0 0 0 0 0 0 0 0 0 0 -8 -8 -8 -8 -8 -8 -8 -8 -8 -8 -8 -8 -8 -8 -8 -8 -8 -8 0 0 0 0 0 0 0 0 0 0 0 0 0 0 0 0 0 0
563 25 25 25 25 25 25 25 25 25 25 25 25 25 25 0 0 25 25 0 0 0 0 0 0 0 0 0 -8 -8 -8 -8 -8 -8 -8 -8 -8 -8 -8 -8 -8 -8 -8 -8 -8 -8 0 0 0 0 0 0 0 0 0 0 0 0 0 0 0 0 0 0
564 25 25 25 25 25 25 25 25 25 25 25 25 25 25 0 25 25 25 0 0 0 0 0 0 0 0 0 -8 -8 -8 -8 -8 -8 -8 -8 -8 -8 -8 -8 -8 -8 -8 -8 -8 -8 0 0 0 0 0 0 0 0 0 0 0 0 0 0 0 0 0 0
587 25 25 25 25 25 25 25 25 25 25 25 25 25 25 0 0 25 25 0 0 0 0 0 0 0 0 0 -8 -8 -8 -8 -8 -8 -8 -8 -8 -8 -8 -8 -8 -8 -8 -8 -8 -8 0 0 0 0 0 0 0 0 0 0 0 0 0 0 0 0 0 0
614 25 25 25 25 25 25 25 25 25 25 25 25 25 25 0 0 25 25 0 25 0 0 0 0 0 0 0 -8 -8 -8 -8 -8 -8 -8 -8 -8 -8 -8 -8 -8 -8 -8 -8 -8 -8 0 0 0 0 0 0 0 0 0 0 0 0 0 0 0 0 0 0
623 25 25 25 25 25 25 25 25 25 25 25 25 25 25 25 0 25 25 0 25 0 0 0 0 0 0 0 -8 -8 -8 -8 -8 -8 -8 -8 -8 -8 -8 -8 -8 -8 -8 -8 -8 -8 0 0 0 0 0 0 0 0 0 0 0 0 0 0 0 0 0 0
626 25 25 25 25 25 25 25 25 25 25 25 25 25 25 25 0 25 25 0 25 25 0 0 0 0 0 0 -8 -8 -8 -8 -8 -8 -8 -8 -8 -8 -8 -8 -8 -8 -8 -8 -8 -8 0 0 0 0 0 0 0 0 0 0 0 0 0 0 0 0 0 0
630 25 25 25 25 25 25 25 25 25 25 25 25 25 25 25 25 25 25 0 25 25 0 0 0 0 0 0 -8 -8 -8 -8 -8 -8 -8 -8 -8 -8 -8 -8 -8 -8 -8 -8 -8 -8 0 0 0 0 0 0 0 0 0 0 0 0 0 0 0 0 0 0
640 25 25 25 25 25 25 25 25 25 25 25 25 25 25 25 25 25 25 0 0 25 0 0 0 0 0 0 -8 -8 -8 -8 -8 -8 -8 -8 -8 -8 -8 -8 -8 -8 -8 -8 -8 -8 0 0 0 0 0 0 0 0 0 0 0 0 0 0 0 0 0 0
641 25 25 25 25 25 25 25 25 25 25 25 25 25 25 25 25 25 25 0 0 0 0 0 0 0 0 0 -8 -8 -8 -8 -8 -8 -8 -8 -8 -8 -8 -8 -8 -8 -8 -8 -8 -8 0 0 0 0 0 0 0 0 0 0 0 0 0 0 0 0 0 0
657 25 25 25 25 25 25 0 0 0 25 25 25 25 25 25 25 25 25 0 0 0 0 0 0 0 0 0 -8 -8 -8 -8 -8 -8 -8 -8 -8 -8 -8 -8 -8 -8 -8 -8 -8 -8 0 0 0 0 0 0 0 0 0 0 0 0 0 0 0 0 0 0
658 25 25 25 25 25 0 0 0 0 25 25 25 25 25 0 0 0 0 0 0 0 0 0 0 0 0 0 -8 -8 -8 -8 -8 -8 -8 -8 -8 -8 -8 -8 -8 -8 -8 -8 -8 -8 0 0 0 0 0 0 0 0 0 0 0 0 0 0 0 0 0 0
666 25 25 25 25 25 0 0 0 0 25 25 25 25 0 0 0 0 0 0 0 0 0 0 0 0 0 0 -8 -8 -8 -8 -8 -8 -8 -8 -8 -8 -8 -8 -8 -8 -8 -8 -8 -8 0 0 0 0 0 0 0 0 0 0 0 0 0 0 0 0 0 0
676 25 25 25 25 25 0 0 0 0 25 25 25 25 25 0 0 0 0 0 0 0 0 0 0 0 0 0 -8 -8 -8 -8 -8 -8 -8 -8 -8 -8 -8 -8 -8 -8 -8 -8 -8 -8 0 0 0 0 0 0 0 0 0 0 0 0 0 0 0 0 0 0
685 25 25 25 25 25 25 25 25 25 25 25 25 25 25 25 25 25 25 0 0 0 0 0 0 0 0 25 -8 -8 -8 -8 -8 -8 -8 -8 -8 -8 -8 -8 -8 -8 -8 -8 -8 -8 0 0 0 0 0 0 0 0 0 0 0 0 0 0 0 0 0 0
686 25 25 25 25 25 25 25 25 25 25 25 25 25 25 25 25 25 25 0 0 0 0 0 0 0 25 25 -8 -8 -8 -8 -8 -8 -8 -8 -8 -8 -8 -8 -8 -8 -8 -8 -8 -8 0 0 0 0 0 0 0 0 0 0 0 0 0 0 0 0 0 0
688 25 25 25 25 25 25 25 25 25 25 25 25 25 25 25 25 25 25 0 0 0 0 0 0 25 25 25 -8 -8 -8 -8 -8 -8 -8 -8 -8 -8 -8 -8 -8 -8 -8 -8 -8 -8 0 0 0 0 0 0 0 0 0 0 0 0 0 0 0 0 0 0
690 25 25 25 25 25 25 25 25 25 25 25 25 25 25 25 25 25 25 0 0 0 0 0 25 25 25 25 -8 -8 -8 -8 -8 -8 -8 -8 -8 -8 -8 -8 -8 -8 -8 -8 -8 -8 0 0 0 0 0 0 0 0 0 0 0 0 0 0 0 0 0 0
692 25 25 25 25 25 25 25 25 25 25 25 25 25 25 25 25 25 25 0 0 0 0 0 0 25 25 25 -8 -8 -8 -8 -8 -8 -8 -8 -8 -8 -8 -8 -8 -8 -8 -8 -8 -8 0 0 0 0 0 0 0 0 0 0 0 0 0 0 0 0 0 0
695 25 25 25 25 25 25 25 25 25 25 25 25 25 25 25 25 25 25 0 0 0 0 0 0 0 25 25 -8 -8 -8 -8 -8 -8 -8 -8 -8 -8 -8 -8 -8 -8 -8 -8 -8 -8 0 0 0 0 0 0 0 0 0 0 0 0 0 0 0 0 0 0
697 25 25 25 25 25 25 25 25 25 25 25 25 25 25 25 25 25 25 0 0 0 0 0 0 0 0 25 -8 -8 -8 -8 -8 -8 -8 -8 -8 -8 -8 -8 -8 -8 -8 -8 -8 -8 0 0 0 0 0 0 0 0 0 0 0 0 0 0 0 0 0 0
698 25 25 25 25 25 25 0 0 0 25 25 25 25 25 0 0 0 0 0 0 0 0 0 0 0 0 0 -8 -8 -8 -8 -8 -8 -8 -8 -8 -8 -8 -8 -8 -8 -8 -8 -8 -8 0 0 0 0 0 0 0 0 0 0 0 0 0 0 0 0 0 0
699 25 25 25 25 25 25 0 0 0 25 25 25 25 25 0 0 0 0 0 0 0 25 0 0 0 0 0 -8 -8 -8 -8 -8 -8 -8 -8 -8 -8 -8 -8 -8 -8 -8 -8 -8 -8 0 0 0 0 0 0 0 0 0 0 0 0 0 0 0 0 0 0
711 25 25 25 25 25 0 0 0 0 25 25 25 25 25 0 0 0 0 0 0 0 25 0 0 0 0 0 -8 -8 -8 -8 -8 -8 -8 -8 -8 -8 -8 -8 -8 -8 -8 -8 -8 -8 0 0 0 0 0 0 0 0 0 0 0 0 0 0 0 0 0 0
720 25 25 25 25 25 0 0 0 0 25 25 25 25 0 0 0 0 0 0 0 0 25 0 0 0 0 0 -8 -8 -8 -8 -8 -8 -8 -8 -8 -8 -8 -8 -8 -8 -8 -8 -8 -8 0 0 0 0 0 0 0 0 0 0 0 0 0 0 0 0 0 0
727 25 25 25 25 25 0 0 0 0 25 25 25 25 0 0 0 0 0 0 0 25 25 0 0 0 0 0 -8 -8 -8 -8 -8 -8 -8 -8 -8 -8 -8 -8 -8 -8 -8 -8 -8 -8 0 0 0 0 0 0 0 0 0 0 0 0 0 0 0 0 0 0
739 25 25 25 25 25 0 0 0 0 25 25 25 25 25 0 0 0 0 0 0 25 25 0 0 0 0 0 -8 -8 -8 -8 -8 -8 -8 -8 -8 -8 -8 -8 -8 -8 -8 -8 -8 -8 0 0 0 0 0 0 0 0 0 0 0 0 0 0 0 0 0 0
741 25 25 25 25 25 25 0 0 0 25 25 25 25 25 0 0 0 0 0 0 25 25 0 0 0 0 0 -8 -8 -8 -8 -8 -8 -8 -8 -8 -8 -8 -8 -8 -8 -8 -8 -8 -8 0 0 0 0 0 0 0 0 0 0 0 0 0 0 0 0 0 0
746 25 25 25 25 25 25 25 25 25 25 25 25 25 25 25 25 25 25 0 0 25 25 0 0 0 25 25 -8 -8 -8 -8 -8 -8 -8 -8 -8 -8 -8 -8 -8 -8 -8 -8 -8 -8 0 0 0 0 0 0 0 0 0 0 0 0 0 0 0 0 0 0
747 25 25 25 25 25 25 25 25 25 25 25 25 25 25 25 25 25 25 0 0 25 25 0 0 25 25 25 -8 -8 -8 -8 -8 -8 -8 -8 -8 -8 -8 -8 -8 -8 -8 -8 -8 -8 0 0 0 0 0 0 0 0 0 0 0 0 0 0 0 0 0 0
749 25 25 25 25 25 25 25 25 25 25 25 25 25 25 25 25 25 25 0 0 25 25 0 25 25 25 25 -8 -8 -8 -8 -8 -8 -8 -8 -8 -8 -8 -8 -8 -8 -8 -8 -8 -8 0 0 0 0 0 0 0 0 0 0 0 0 0 0 0 0 0 0
752 25 25 25 25 25 25 25 25 25 25 25 25 25 25 25 25 25 25 0 0 25 25 25 25 25 25 25 -8 -8 -8 -8 -8 -8 -8 -8 -8 -8 -8 -8 -8 -8 -8 -8 -8 -8 0 0 0 0 0 0 0 0 0 0 0 0 0 0 0 0 0 0
753 25 25 25 25 25 25 25 25 25 25 25 25 25 25 25 25 25 25 0 0 25 25 0 25 25 25 25 -8 -8 -8 -8 -8 -8 -8 -8 -8 -8 -8 -8 -8 -8 -8 -8 -8 -8 0 0 0 0 0 0 0 0 0 0 0 0 0 0 0 0 0 0
755 25 25 25 25 25 25 25 25 25 25 25 25 25 25 25 25 25 25 0 0 25 25 0 0 25 25 25 -8 -8 -8 -8 -8 -8 -8 -8 -8 -8 -8 -8 -8 -8 -8 -8 -8 -8 0 0 0 0 0 0 0 0 0 0 0 0 0 0 0 0 0 0
758 25 25 25 25 25 25 25 25 25 25 25 25 25 25 25 25 25 25 0 25 25 25 0 0 0 25 25 -8 -8 -8 -8 -8 -8 -8 -8 -8 -8 -8 -8 -8 -8 -8 -8 -8 -8 0 0 0 0 0 0 0 0 0 0 0 0 0 0 0 0 0 0
759 25 25 25 25 25 25 0 0 0 25 25 25 25 25 0 0 0 0 0 25 25 25 0 0 0 0 0 -8 -8 -8 -8 -8 -8 -8 -8 -8 -8 -8 -8 -8 -8 -8 -8 -8 -8 0 0 0 0 0 0 0 0 0 0 0 0 0 0 0 0 0 0
767 25 25 25 25 25 0 0 0 0 25 25 25 25 25 0 0 0 0 0 25 25 25 0 0 0 0 0 -8 -8 -8 -8 -8 -8 -8 -8 -8 -8 -8 -8 -8 -8 -8 -8 -8 -8 0 0 0 0 0 0 0 0 0 0 0 0 0 0 0 0 0 0
778 25 25 25 25 25 25 0 0 0 25 25 25 25 25 0 0 0 0 0 25 25 25 0 0 0 0 0 -8 -8 -8 -8 -8 -8 -8 -8 -8 -8 -8 -8 -8 -8 -8 -8 -8 -8 0 0 0 0 0 0 0 0 0 0 0 0 0 0 0 0 0 0
780 25 25 25 25 25 25 0 0 0 25 25 25 25 25 0 0 0 0 25 25 25 25 0 0 0 0 0 -8 -8 -8 -8 -8 -8 -8 -8 -8 -8 -8 -8 -8 -8 -8 -8 -8 -8 0 0 0 0 0 0 0 0 0 0 0 0 0 0 0 0 0 0
786 25 25 25 25 25 25 25 25 25 25 25 25 25 25 0 25 25 25 25 25 25 25 0 0 0 0 0 -8 -8 -8 -8 -8 -8 -8 -8 -8 -8 -8 -8 -8 -8 -8 -8 -8 -8 0 0 0 0 0 0 0 0 0 0 0 0 0 0 0 0 0 0
787 25 25 25 25 25 25 25 25 25 25 25 25 25 25 25 25 25 25 25 25 25 25 0 0 0 0 0 -8 -8 -8 -8 -8 -8 -8 -8 -8 -8 -8 -8 -8 -8 -8 -8 -8 -8 0 0 0 0 0 0 0 0 0 0 0 0 0 0 0 0 0 0
788 25 25 25 25 25 25 25 25 25 25 25 25 25 25 25 25 25 25 25 25 25 25 0 0 0 25 0 -8 -8 -8 -8 -8 -8 -8 -8 -8 -8 -8 -8 -8 -8 -8 -8 -8 -8 0 0 0 0 0 0 0 0 0 0 0 0 0 0 0 0 0 0
789 25 25 25 25 25 25 25 25 25 25 25 25 25 25 25 25 25 25 25 25 25 25 0 0 0 25 25 -8 -8 -8 -8 -8 -8 -8 -8 -8 -8 -8 -8 -8 -8 -8 -8 -8 -8 0 0 0 0 0 0 0 0 0 0 0 0 0 0 0 0 0 0
803 25 25 25 25 25 25 25 25 25 25 25 25 25 25 25 25 25 25 25 25 25 0 0 0 0 25 25 -8 -8 -8 -8 -8 -8 -8 -8 -8 -8 -8 -8 -8 -8 -8 -8 -8 -8 0 0 0 0 0 0 0 0 0 0 0 0 0 0 0 0 0 0
804 25 25 25 25 25 25 25 25 25 25 25 25 25 25 25 25 25 25 25 25 0 0 0 0 0 25 25 -8 -8 -8 -8 -8 -8 -8 -8 -8 -8 -8 -8 -8 -8 -8 -8 -8 -8 0 0 0 0 0 0 0 0 0 0 0 0 0 0 0 0 0 0
814 25 25 25 25 25 25 25 25 25 25 25 25 25 25 25 25 25 25 25 0 0 0 0 0 0 25 25 -8 -8 -8 -8 -8 -8 -8 -8 -8 -8 -8 -8 -8 -8 -8 -8 -8 -8 0 0 0 0 0 0 0 0 0 0 0 0 0 0 0 0 0 0
820 25 25 25 25 25 25 25 25 25 25 25 25 25 25 25 25 25 25 0 0 0 0 0 0 0 25 25 -8 -8 -8 -8 -8 -8 -8 -8 -8 -8 -8 -8 -8 -8 -8 -8 -8 -8 0 0 0 0 0 0 0 0 0 0 0 0 0 0 0 0 0 0
864 25 25 25 25 25 25 25 25 25 25 25 25 25 25 25 25 25 25 0 0 0 0 0 0 0 0 25 -8 -8 -8 -8 -8 -8 -8 -8 -8 -8 -8 -8 -8 -8 -8 -8 -8 -8 0 0 0 0 0 0 0 0 0 0 0 0 0 0 0 0 0 0
877 25 25 25 25 25 25 25 25 25 25 25 25 25 25 25 25 25 25 0 0 0 0 0 0 0 0 0 -8 -8 -8 -8 -8 -8 -8 -8 -8 -8 -8 -8 -8 -8 -8 -8 -8 -8 0 0 0 0 0 0 0 0 0 0 0 0 0 0 0 0 0 0
881 25 25 25 25 25 25 25 25 25 25 25 25 25 25 25 0 25 25 0 0 0 0 0 0 0 0 0 -8 -8 -8 -8 -8 -8 -8 -8 -8 -8 -8 -8 -8 -8 -8 -8 -8 -8 0 0 0 0 0 0 0 0 0 0 0 0 0 0 0 0 0 0
892 25 25 25 25 25 25 25 25 25 25 25 25 25 25 25 0 25 25 0 0 0 0 0 0 0 0 0 0 -8 -8 -8 -8 -8 -8 -8 -8 -8 -8 -8 -8 -8 -8 -8 -8 -8 0 0 0 0 0 0 0 0 0 0 0 0 0 0 0 0 0 0
893 25 25 25 25 25 25 25 25 25 25 25 25 25 25 25 0 25 25 0 0 0 0 0 0 0 0 0 0 -8 -8 -8 -8 -8 -8 -8 0 -8 -8 -8 -8 -8 -8 -8 -8 -8 0 0 0 0 0 0 0 0 0 0 0 0 0 0 0 0 0 0
894 25 25 25 25 25 25 25 25 25 25 25 25 25 25 25 0 0 25 0 0 0 0 0 0 0 0 0 0 -8 -8 -8 -8 -8 -8 -8 0 -8 -8 -8 -8 -8 -8 -8 -8 -8 0 0 0 0 0 0 0 0 0 0 0 0 0 0 0 0 0 0
896 25 25 25 25 25 25 25 25 25 25 25 25 25 25 25 0 0 25 0 0 0 0 0 0 0 0 0 0 -8 -8 -8 -8 -8 -8 -8 -8 -8 -8 -8 -8 -8 -8 -8 -8 -8 0 0 0 0 0 0 0 0 0 0 0 0 0 0 0 0 0 0
897 25 25 25 25 25 25 25 25 25 25 25 25 25 25 25 0 0 25 0 0 0 0 0 0 0 0 0 -8 -8 -8 -8 -8 -8 -8 -8 -8 -8 -8 -8 -8 -8 -8 -8 -8 -8 0 0 0 0 0 0 0 0 0 0 0 0 0 0 0 0 0 0
910 25 25 25 25 25 25 25 25 25 25 25 25 25 25 25 0 0 25 0 0 0 0 0 0 0 -8 -8 -8 -8 -8 -8 -8 -8 -8 -8 -8 -8 -8 -8 -8 -8 -8 -8 -8 -8 0 0 0 0 0 0 0 0 0 0 0 0 0 0 0 0 0 0
921 25 25 25 25 25 25 25 25 25 25 25 25 25 25 25 0 0 0 0 0 0 0 0 0 0 0 -8 -8 -8 -8 -8 -8 -8 -8 -8 -8 -8 -8 -8 -8 -8 -8 -8 -8 -8 0 0 0 0 0 0 0 0 0 0 0 0 0 0 0 0 0 0
938 25 25 25 25 25 25 25 25 25 25 25 25 25 25 25 0 0 0 0 0 0 0 0 0 0 0 0 -8 -8 -8 -8 -8 -8 -8 -8 -8 -8 -8 -8 -8 -8 -8 -8 -8 -8 0 0 0 0 0 0 0 0 0 0 0 0 0 0 0 0 0 0
941 25 25 25 25 25 25 25 0 25 25 25 25 25 25 25 0 0 0 0 0 0 0 0 0 0 0 0 -8 -8 -8 -8 -8 -8 -8 -8 -8 -8 -8 -8 -8 -8 -8 -8 -8 -8 0 0 0 0 0 0 0 0 0 0 0 0 0 0 0 0 0 0
942 25 25 25 25 25 25 25 0 0 25 25 25 25 25 25 0 0 0 0 0 0 0 0 0 0 0 0 -8 -8 -8 -8 -8 -8 -8 -8 -8 -8 -8 -8 -8 -8 -8 -8 -8 -8 0 0 0 0 0 0 0 0 0 0 0 0 0 0 0 0 0 0
969 25 25 25 25 25 25 25 25 25 25 25 25 25 25 25 0 0 0 0 0 0 0 0 0 0 0 0 -8 -8 -8 -8 -8 -8 -8 -8 -8 -8 -8 -8 -8 -8 -8 -8 -8 -8 0 0 0 0 0 0 0 0 0 0 0 0 0 0 0 0 0 0
970 25 25 25 25 25 25 25 25 25 25 25 25 25 25 25 0 0 25 0 0 0 0 0 0 0 0 0 -8 -8 -8 -8 -8 -8 -8 -8 -8 -8 -8 -8 -8 -8 -8 -8 -8 -8 0 0 0 0 0 0 0 0 0 0 0 0 0 0 0 0 0 0
983 25 25 25 25 25 25 25 25 25 25 25 25 25 25 0 0 0 25 0 0 0 0 0 0 0 0 0 -8 -8 -8 -8 -8 -8 -8 -8 -8 -8 -8 -8 -8 -8 -8 -8 -8 -8 0 0 0 0 0 0 0 0 0 0 0 0 0 0 0 0 0 0
990 25 25 25 25 25 25 25 25 25 25 25 25 25 25 0 0 0 0 0 0 0 0 0 0 0 0 0 -8 -8 -8 -8 -8 -8 -8 -8 -8 -8 -8 -8 -8 -8 -8 -8 -8 -8 0 0 0 0 0 0 0 0 0 0 0 0 0 0 0 0 0 0
1017 25 25 25 25 25 25 25 25 25 25 25 25 25 0 0 0 0 0 0 0 0 0 0 0 0 0 0 -8 -8 -8 -8 -8 -8 -8 -8 -8 -8 -8 -8 -8 -8 -8 -8 -8 -8 0 0 0 0 0 0 0 0 0 0 0 0 0 0 0 0 0 0
1020 25 25 25 25 25 25 25 25 25 25 25 25 25 0 0 0 25 0 0 0 0 0 0 0 0 0 0 -8 -8 -8 -8 -8 -8 -8 -8 -8 -8 -8 -8 -8 -8 -8 -8 -8 -8 0 0 0 0 0 0 0 0 0 0 0 0 0 0 0 0 0 0
1022 25 25 25 25 25 25 25 25 25 25 25 25 25 0 0 0 25 25 0 0 0 0 0 0 0 0 0 -8 -8 -8 -8 -8 -8 -8 -8 -8 -8 -8 -8 -8 -8 -8 -8 -8 -8 0 0 0 0 0 0 0 0 0 0 0 0 0 0 0 0 0 0
1029 25 25 25 25 25 25 25 25 25 25 25 25 0 0 0 0 25 25 0 0 0 0 0 0 0 0 0 -8 -8 -8 -8 -8 -8 -8 -8 -8 -8 -8 -8 -8 -8 -8 -8 -8 -8 0 0 0 0 0 0 0 0 0 0 0 0 0 0 0 0 0 0
1031 25 25 25 25 25 25 25 25 25 25 25 0 0 0 0 0 25 25 0 0 0 0 0 0 0 0 0 -8 -8 -8 -8 -8 -8 -8 -8 -8 -8 -8 -8 -8 -8 -8 -8 -8 -8 0 0 0 0 0 0 0 0 0 0 0 0 0 0 0 0 0 0
1041 25 25 25 25 25 25 25 25 25 25 25 0 25 25 0 0 0 25 0 0 0 0 0 0 0 0 0 -8 -8 -8 -8 -8 -8 -8 -8 -8 -8 -8 -8 -8 -8 -8 -8 -8 -8 0 0 0 0 0 0 0 0 0 0 0 0 0 0 0 0 0 0
1042 25 25 25 25 25 25 25 25 25 25 25 0 25 25 0 0 0 0 0 0 0 0 0 0 0 0 0 -8 -8 -8 -8 -8 -8 -8 -8 -8 -8 -8 -8 -8 -8 -8 -8 -8 -8 0 0 0 0 0 0 0 0 0 0 0 0 0 0 0 0 0 0
1043 25 25 25 25 25 25 25 25 0 25 25 25 25 25 0 0 0 0 0 0 0 0 0 0 0 0 0 -8 -8 -8 -8 -8 -8 -8 -8 -8 -8 -8 -8 -8 -8 -8 -8 -8 -8 0 0 0 0 0 0 0 0 0 0 0 0 0 0 0 0 0 0
1044 25 25 25 25 25 25 0 0 0 25 25 25 25 25 0 0 0 0 0 0 0 0 0 0 0 0 0 -8 -8 -8 -8 -8 -8 -8 -8 -8 -8 -8 -8 -8 -8 -8 -8 -8 -8 0 0 0 0 0 0 0 0 0 0 0 0 0 0 0 0 0 0
1076 25 25 25 25 25 0 0 0 0 25 25 25 25 25 0 0 0 0 0 0 0 0 0 0 0 0 0 -8 -8 -8 -8 -8 -8 -8 -8 -8 -8 -8 -8 -8 -8 -8 -8 -8 -8 0 0 0 0 0 0 0 0 0 0 0 0 0 0 0 0 0 0
1079 25 25 25 25 25 25 0 0 0 25 25 25 25 25 0 0 0 0 0 0 0 0 0 0 0 0 0 -8 -8 -8 -8 -8 -8 -8 -8 -8 -8 -8 -8 -8 -8 -8 -8 -8 -8 0 0 0 0 0 0 0 0 0 0 0 0 0 0 0 0 0 0
1087 25 25 25 25 25 25 0 0 0 25 25 25 25 25 0 0 0 0 0 0 0 0 0 -8 0 0 0 -8 -8 -8 -8 -8 -8 -8 -8 -8 -8 -8 -8 -8 -8 -8 -8 -8 -8 0 0 0 0 0 0 0 0 0 0 0 0 0 0 0 0 0 0
1091 25 25 25 25 25 25 25 25 25 25 25 25 25 25 0 0 0 25 0 0 0 0 0 -8 0 0 0 -8 -8 -8 -8 -8 -8 -8 -8 -8 -8 -8 -8 -8 -8 -8 -8 -8 -8 0 0 0 0 0 0 0 0 0 0 0 0 0 0 0 0 0 0
1092 25 25 25 25 25 25 25 25 25 25 25 25 25 25 0 0 25 25 0 0 0 0 0 -8 0 0 0 -8 -8 -8 -8 -8 -8 -8 -8 -8 -8 -8 -8 -8 -8 -8 -8 -8 -8 0 0 0 0 0 0 0 0 0 0 0 0 0 0 0 0 0 0
1103 25 25 25 25 25 25 25 25 25 25 25 25 25 25 0 0 0 25 0 0 0 0 0 -8 0 0 0 -8 -8 -8 -8 -8 -8 -8 -8 -8 -8 -8 -8 -8 -8 -8 -8 -8 -8 0 0 0 0 0 0 0 0 0 0 0 0 0 0 0 0 0 0
1104 25 25 25 25 25 25 25 25 25 25 25 25 25 25 0 0 0 0 0 0 0 0 0 -8 0 0 0 -8 -8 -8 -8 -8 -8 -8 -8 -8 -8 -8 -8 -8 -8 -8 -8 -8 -8 0 0 0 0 0 0 0 0 0 0 0 0 0 0 0 0 0 0
1105 25 25 25 25 25 25 25 0 0 25 25 25 25 25 0 0 0 0 0 0 0 0 0 -8 0 0 0 -8 -8 -8 -8 -8 -8 -8 -8 -8 -8 -8 -8 -8 -8 -8 -8 -8 -8 0 0 0 0 0 0 0 0 0 0 0 0 0 0 0 0 0 0
1106 25 25 25 25 25 25 25 0 0 25 25 25 25 25 0 0 0 0 0 0 0 0 0 0 0 0 0 -8 -8 -8 -8 -8 -8 -8 -8 -8 -8 -8 -8 -8 -8 -8 -8 -8 -8 0 0 0 0 0 0 0 0 0 0 0 0 0 0 0 0 0 0
1112 25 25 25 25 25 25 0 0 0 25 25 25 25 25 0 0 0 0 0 0 0 0 0 0 0 0 0 -8 -8 -8 -8 -8 -8 -8 -8 -8 -8 -8 -8 -8 -8 -8 -8 -8 -8 0 0 0 0 0 0 0 0 0 0 0 0 0 0 0 0 0 0
1129 25 25 25 25 25 0 0 0 0 25 25 25 25 25 0 0 0 0 0 0 0 0 0 0 0 0 0 -8 -8 -8 -8 -8 -8 -8 -8 -8 -8 -8 -8 -8 -8 -8 -8 -8 -8 0 0 0 0 0 0 0 0 0 0 0 0 0 0 0 0 0 0
1151 25 25 25 25 25 25 0 0 0 25 25 25 25 25 0 0 0 0 0 0 0 0 0 0 0 0 0 -8 -8 -8 -8 -8 -8 -8 -8 -8 -8 -8 -8 -8 -8 -8 -8 -8 -8 0 0 0 0 0 0 0 0 0 0 0 0 0 0 0 0 0 0
1152 25 25 25 25 25 25 0 25 25 25 25 25 25 25 0 0 0 25 0 0 0 0 0 0 0 0 0 -8 -8 -8 -8 -8 -8 -8 -8 -8 -8 -8 -8 -8 -8 -8 -8 -8 -8 0 0 0 0 0 0 0 0 0 0 0 0 0 0 0 0 0 0
1157 25 25 25 25 25 25 25 25 25 25 25 25 25 25 0 0 25 25 0 0 0 0 0 0 0 0 0 -8 -8 -8 -8 -8 -8 -8 -8 -8 -8 -8 -8 -8 -8 -8 -8 -8 -8 0 0 0 0 0 0 0 0 0 0 0 0 0 0 0 0 0 0
1160 25 25 25 25 25 25 0 25 25 25 25 25 25 25 0 0 25 25 0 0 0 0 0 0 0 0 0 -8 -8 -8 -8 -8 -8 -8 -8 -8 -8 -8 -8 -8 -8 -8 -8 -8 -8 0 0 0 0 0 0 0 0 0 0 0 0 0 0 0 0 0 0
1161 25 25 25 25 25 25 0 25 25 25 25 25 25 25 0 0 0 25 0 0 0 0 0 0 0 0 0 -8 -8 -8 -8 -8 -8 -8 -8 -8 -8 -8 -8 -8 -8 -8 -8 -8 -8 0 0 0 0 0 0 0 0 0 0 0 0 0 0 0 0 0 0
1165 25 25 25 25 25 0 0 25 0 25 25 25 25 25 0 0 0 0 0 0 0 0 0 0 0 0 0 -8 -8 -8 -8 -8 -8 -8 -8 -8 -8 -8 -8 -8 -8 -8 -8 -8 -8 0 0 0 0 0 0 0 0 0 0 0 0 0 0 0 0 0 0
1166 25 25 25 25 25 0 0 0 0 25 25 25 25 25 0 0 0 0 0 0 0 0 0 0 0 0 0 -8 -8 -8 -8 -8 -8 -8 -8 -8 -8 -8 -8 -8 -8 -8 -8 -8 -8 0 0 0 0 0 0 0 0 0 0 0 0 0 0 0 0 0 0
1180 25 25 25 25 25 0 0 0 0 25 25 25 25 25 0 0 0 0 0 0 0 0 0 0 0 -8 -8 -8 -8 -8 -8 -8 -8 -8 -8 -8 -8 -8 -8 -8 -8 -8 -8 -8 -8 0 0 0 0 0 0 0 0 0 0 0 0 0 0 0 0 0 0
1190 25 25 25 25 25 25 0 0 0 25 25 25 25 25 0 0 0 0 0 0 0 0 0 0 0 -8 -8 -8 -8 -8 -8 -8 -8 -8 -8 -8 -8 -8 -8 -8 -8 -8 -8 -8 -8 0 0 0 0 0 0 0 0 0 0 0 0 0 0 0 0 0 0
1193 25 25 25 25 25 25 25 25 25 25 25 25 25 25 0 0 0 0 0 0 0 0 0 0 0 -8 -8 -8 -8 -8 -8 -8 -8 -8 -8 -8 -8 -8 -8 -8 -8 -8 -8 -8 -8 0 0 0 0 0 0 0 0 0 0 0 0 0 0 0 0 0 0
1198 25 25 25 25 25 25 25 25 25 25 25 25 25 25 0 0 25 0 0 0 0 0 0 0 0 -8 -8 -8 -8 -8 -8 -8 -8 -8 -8 -8 -8 -8 -8 -8 -8 -8 -8 -8 -8 0 0 0 0 0 0 0 0 0 0 0 0 0 0 0 0 0 0
1199 25 25 25 25 25 25 25 25 25 25 25 25 25 25 0 0 25 25 0 0 0 0 0 0 0 -8 -8 -8 -8 -8 -8 -8 -8 -8 -8 -8 -8 -8 -8 -8 -8 -8 -8 -8 -8 0 0 0 0 0 0 0 0 0 0 0 0 0 0 0 0 0 0
