0 12 12 12 12 12 12 12 12 12 12 12 12 12 12 12 12 0 0 0 0 0 0 0 0 0 0 0 -8 -8 -8 -8 -8 -8 -8 -8 -8 -8 -8 -8 -8 -8 -8 -8 -8 -8 0 0 0 0 0 0 0 0 0 0 0 0 0 0 0 0 0 0
41 12 12 12 12 12 12 12 12 12 12 12 12 12 12 12 12 12 0 0 0 0 0 0 0 0 0 -8 -8 -8 -8 -8 -8 -8 -8 -8 -8 -8 -8 -8 -8 -8 -8 -8 -8 -8 0 0 0 0 0 0 0 0 0 0 0 0 0 0 0 0 0 0
42 12 12 12 12 12 12 12 12 12 12 12 12 12 12 12 12 0 0 0 0 0 0 0 0 0 0 0 -8 -8 -8 -8 -8 -8 -8 -8 -8 -8 -8 -8 -8 -8 -8 -8 -8 -8 0 0 0 0 0 0 0 0 0 0 0 0 0 0 0 0 0 0
57 12 12 12 12 12 12 12 12 12 12 12 12 12 12 12 12 0 0 12 0 0 0 0 0 0 0 0 -8 -8 -8 -8 -8 -8 -8 -8 -8 -8 -8 -8 -8 -8 -8 -8 -8 -8 0 0 0 0 0 0 0 0 0 0 0 0 0 0 0 0 0 0
63 12 12 12 12 12 12 12 12 12 12 12 12 12 12 12 12 0 0 0 0 0 0 0 0 0 0 0 -8 -8 -8 -8 -8 -8 -8 -8 -8 -8 -8 -8 -8 -8 -8 -8 -8 -8 0 0 0 0 0 0 0 0 0 0 0 0 0 0 0 0 0 0
84 12 12 12 12 12 12 12 12 12 0 12 12 12 12 12 12 0 0 0 0 0 0 0 0 0 0 0 -8 -8 -8 -8 -8 -8 -8 -8 -8 -8 -8 -8 -8 -8 -8 -8 -8 -8 0 0 0 0 0 0 0 0 0 0 0 0 0 0 0 0 0 0
87 12 12 12 12 12 12 12 12 12 0 12 12 12 12 12 12 12 0 0 0 0 0 0 0 0 0 0 -8 -8 -8 -8 -8 -8 -8 -8 -8 -8 -8 -8 -8 -8 -8 -8 -8 -8 0 0 0 0 0 0 0 0 0 0 0 0 0 0 0 0 0 0
89 12 12 12 12 12 12 12 12 12 0 0 12 12 12 12 12 12 0 0 0 0 0 0 0 0 0 0 -8 -8 -8 -8 -8 -8 -8 -8 -8 -8 -8 -8 -8 -8 -8 -8 -8 -8 0 0 0 0 0 0 0 0 0 0 0 0 0 0 0 0 0 0
111 12 12 12 12 12 12 12 12 12 0 0 12 12 12 12 12 0 0 0 0 0 0 0 0 0 0 0 -8 -8 -8 -8 -8 -8 -8 -8 -8 -8 -8 -8 -8 -8 -8 -8 -8 -8 0 0 0 0 0 0 0 0 0 0 0 0 0 0 0 0 0 0
115 12 12 12 12 12 12 12 12 12 0 12 12 12 12 12 12 0 0 0 0 0 0 0 0 0 -8 0 -8 -8 -8 -8 -8 -8 -8 -8 -8 -8 -8 -8 -8 -8 -8 -8 -8 -8 0 0 0 0 0 0 0 0 0 0 0 0 0 0 0 0 0 0
120 12 12 12 12 12 12 12 12 12 12 12 12 12 12 12 12 0 0 0 0 0 0 0 0 0 -8 -8 -8 -8 -8 -8 -8 -8 -8 -8 -8 -8 -8 -8 -8 -8 -8 -8 -8 -8 0 0 0 0 0 0 0 0 0 0 0 0 0 0 0 0 0 0
125 12 12 12 12 12 12 12 12 12 12 12 12 12 12 12 12 0 0 0 0 0 0 0 0 0 -8 0 -8 -8 -8 -8 -8 -8 -8 -8 -8 -8 -8 -8 -8 -8 -8 -8 -8 -8 0 0 0 0 0 0 0 0 0 0 0 0 0 0 0 0 0 0
127 12 12 12 12 12 12 12 12 12 12 12 12 12 12 12 12 0 0 0 0 0 0 0 0 0 0 0 -8 -8 -8 -8 -8 -8 -8 -8 -8 -8 -8 -8 -8 -8 -8 -8 -8 -8 0 0 0 0 0 0 0 0 0 0 0 0 0 0 0 0 0 0
130 12 12 12 12 12 12 12 12 12 0 12 12 12 12 12 12 0 0 0 0 0 0 0 0 0 0 0 -8 -8 -8 -8 -8 -8 -8 -8 -8 -8 -8 -8 -8 -8 -8 -8 -8 -8 0 0 0 0 0 0 0 0 0 0 0 0 0 0 0 0 0 0
138 12 12 12 12 12 12 12 12 12 0 12 12 12 12 12 12 0 0 0 0 0 0 -8 0 0 0 0 -8 -8 -8 -8 -8 -8 -8 -8 -8 -8 -8 -8 -8 -8 -8 -8 -8 -8 0 0 0 0 0 0 0 0 0 0 0 0 0 0 0 0 0 0
150 12 12 12 12 12 12 12 12 12 12 12 12 12 12 12 12 0 0 0 0 0 0 -8 0 0 0 0 -8 -8 -8 -8 -8 -8 -8 -8 -8 -8 -8 -8 -8 -8 -8 -8 -8 -8 0 0 0 0 0 0 0 0 0 0 0 0 0 0 0 0 0 0
152 12 12 12 12 12 12 12 12 12 12 12 12 12 12 12 12 0 0 0 0 0 0 0 0 0 0 0 -8 -8 -8 -8 -8 -8 -8 -8 -8 -8 -8 -8 -8 -8 -8 -8 -8 -8 0 0 0 0 0 0 0 0 0 0 0 0 0 0 0 0 0 0
155 12 12 12 12 12 12 12 12 12 12 12 12 12 12 12 12 0 0 0 0 0 0 0 0 -8 0 0 -8 -8 -8 -8 -8 -8 -8 -8 -8 -8 -8 -8 -8 -8 -8 -8 -8 -8 0 0 0 0 0 0 0 0 0 0 0 0 0 0 0 0 0 0
166 12 12 12 12 12 12 12 12 12 12 12 12 12 12 12 12 0 0 0 0 0 0 0 0 0 0 0 -8 -8 -8 -8 -8 -8 -8 -8 -8 -8 -8 -8 -8 -8 -8 -8 -8 -8 0 0 0 0 0 0 0 0 0 0 0 0 0 0 0 0 0 0
169 12 12 12 12 12 12 12 12 12 12 12 12 12 12 12 12 12 0 0 0 0 0 0 0 0 0 0 -8 -8 -8 -8 -8 -8 -8 -8 -8 -8 -8 -8 -8 -8 -8 -8 -8 -8 0 0 0 0 0 0 0 0 0 0 0 0 0 0 0 0 0 0
175 12 12 12 12 12 12 12 12 12 12 12 12 12 12 12 12 12 12 0 0 0 0 0 0 0 0 0 -8 -8 -8 -8 -8 -8 -8 -8 -8 -8 -8 -8 -8 -8 -8 -8 -8 -8 0 0 0 0 0 0 0 0 0 0 0 0 0 0 0 0 0 0
220 12 12 12 12 12 12 12 12 12 12 12 12 12 0 12 12 12 12 0 0 0 0 -8 0 0 0 0 -8 -8 -8 -8 -8 -8 -8 -8 -8 -8 -8 -8 -8 -8 -8 -8 -8 -8 0 0 0 0 0 0 0 0 0 0 0 0 0 0 0 0 0 0
225 12 12 12 12 12 12 12 12 12 12 12 12 12 0 0 12 12 12 0 0 0 0 -8 0 0 0 0 -8 -8 -8 -8 -8 -8 -8 -8 -8 -8 -8 -8 -8 -8 -8 -8 -8 -8 0 0 0 0 0 0 0 0 0 0 0 0 0 0 0 0 0 0
228 12 12 12 12 12 12 12 12 12 12 12 12 12 0 0 0 12 12 0 0 0 0 -8 0 0 0 0 -8 -8 -8 -8 -8 -8 -8 -8 -8 -8 -8 -8 -8 -8 -8 -8 -8 -8 0 0 0 0 0 0 0 0 0 0 0 0 0 0 0 0 0 0
231 12 12 12 12 12 12 12 12 12 12 12 12 12 0 0 0 0 12 0 0 0 0 -8 0 0 0 0 -8 -8 -8 -8 -8 -8 -8 -8 -8 -8 -8 -8 -8 -8 -8 -8 -8 -8 0 0 0 0 0 0 0 0 0 0 0 0 0 0 0 0 0 0
239 12 12 12 12 12 12 12 12 12 12 12 12 12 0 0 0 0 0 0 0 0 0 -8 0 0 0 0 -8 -8 -8 -8 -8 -8 -8 -8 -8 -8 -8 -8 -8 -8 -8 -8 -8 -8 0 0 0 0 0 0 0 0 0 0 0 0 0 0 0 0 0 0
246 12 12 12 12 12 0 12 12 12 12 12 12 12 0 0 0 0 0 0 0 0 0 -8 0 0 0 0 -8 -8 -8 -8 -8 -8 -8 -8 -8 -8 -8 -8 -8 -8 -8 -8 -8 -8 0 0 0 0 0 0 0 0 0 0 0 0 0 0 0 0 0 0
247 12 12 12 12 12 0 0 12 12 12 12 12 12 0 0 0 0 0 0 0 0 0 -8 0 0 0 0 -8 -8 -8 -8 -8 -8 -8 -8 -8 -8 -8 -8 -8 -8 -8 -8 -8 -8 0 0 0 0 0 0 0 0 0 0 0 0 0 0 0 0 0 0
251 12 12 12 12 12 0 0 0 0 12 12 12 12 0 0 0 0 0 0 0 0 0 -8 0 0 0 0 -8 -8 -8 -8 -8 -8 -8 -8 -8 -8 -8 -8 -8 -8 -8 -8 -8 -8 0 0 0 0 0 0 0 0 0 0 0 0 0 0 0 0 0 0
261 12 12 12 12 12 0 0 0 0 12 12 12 12 0 0 0 0 0 0 0 0 0 0 0 0 0 0 -8 -8 -8 -8 -8 -8 -8 -8 -8 -8 -8 -8 -8 -8 -8 -8 -8 -8 0 0 0 0 0 0 0 0 0 0 0 0 0 0 0 0 0 0
264 12 12 12 12 12 0 0 0 0 12 12 12 12 12 0 0 0 0 0 0 0 0 0 0 0 0 0 -8 -8 -8 -8 -8 -8 -8 -8 -8 -8 -8 -8 -8 -8 -8 -8 -8 -8 0 0 0 0 0 0 0 0 0 0 0 0 0 0 0 0 0 0
270 12 12 12 12 12 0 0 0 0 12 12 12 12 12 0 0 0 0 0 0 0 0 -8 0 0 0 0 -8 -8 -8 -8 -8 -8 -8 -8 -8 -8 -8 -8 -8 -8 -8 -8 -8 -8 0 0 0 0 0 0 0 0 0 0 0 0 0 0 0 0 0 0
278 12 12 12 12 12 12 12 12 12 12 12 12 12 12 0 0 0 0 0 0 0 0 -8 -8 0 0 0 -8 -8 -8 -8 -8 -8 -8 -8 -8 -8 -8 -8 -8 -8 -8 -8 -8 -8 0 0 0 0 0 0 0 0 0 0 0 0 0 0 0 0 0 0
289 12 12 12 12 12 12 12 12 12 12 12 12 12 0 0 0 0 0 0 0 0 0 -8 -8 0 0 0 -8 -8 -8 -8 -8 -8 -8 -8 -8 -8 -8 -8 -8 -8 -8 -8 -8 -8 0 0 0 0 0 0 0 0 0 0 0 0 0 0 0 0 0 0
297 12 12 12 12 12 12 12 12 12 12 12 12 12 0 0 0 0 0 0 0 0 0 -8 0 0 0 0 -8 -8 -8 -8 -8 -8 -8 -8 -8 -8 -8 -8 -8 -8 -8 -8 -8 -8 0 0 0 0 0 0 0 0 0 0 0 0 0 0 0 0 0 0
308 12 12 12 12 12 12 12 12 12 12 12 12 12 0 0 0 0 0 0 0 0 0 0 0 0 0 0 -8 -8 -8 -8 -8 -8 -8 -8 -8 -8 -8 -8 -8 -8 -8 -8 -8 -8 0 0 0 0 0 0 0 0 0 0 0 0 0 0 0 0 0 0
337 12 12 12 12 12 12 12 0 12 12 12 12 12 0 0 0 0 0 0 0 0 0 -8 0 0 0 0 -8 -8 -8 -8 -8 -8 -8 -8 -8 -8 -8 -8 -8 -8 -8 -8 -8 -8 0 0 0 0 0 0 0 0 0 0 0 0 0 0 0 0 0 0
343 12 12 12 12 12 12 12 0 0 12 12 12 12 0 0 0 0 0 0 0 0 0 -8 0 0 0 0 -8 -8 -8 -8 -8 -8 -8 -8 -8 -8 -8 -8 -8 -8 -8 -8 -8 -8 0 0 0 0 0 0 0 0 0 0 0 0 0 0 0 0 0 0
349 12 12 12 12 12 12 0 0 0 12 12 12 12 0 0 0 0 0 0 0 0 0 -8 0 0 0 0 -8 -8 -8 -8 -8 -8 -8 -8 -8 -8 -8 -8 -8 -8 -8 -8 -8 -8 0 0 0 0 0 0 0 0 0 0 0 0 0 0 0 0 0 0
360 12 12 12 12 12 12 0 0 0 12 12 12 12 0 0 0 0 0 0 0 0 0 0 0 0 0 0 -8 -8 -8 -8 -8 -8 -8 -8 -8 -8 -8 -8 -8 -8 -8 -8 -8 -8 0 0 0 0 0 0 0 0 0 0 0 0 0 0 0 0 0 0
373 12 12 12 12 12 12 0 0 0 12 12 12 12 12 0 0 0 0 0 0 0 0 0 0 0 0 0 -8 -8 -8 -8 -8 -8 -8 -8 -8 -8 -8 -8 -8 -8 -8 -8 -8 -8 0 0 0 0 0 0 0 0 0 0 0 0 0 0 0 0 0 0
439 12 12 12 12 12 12 12 0 0 12 12 12 12 12 0 0 0 0 0 0 0 0 0 0 0 0 0 -8 -8 -8 -8 -8 -8 -8 -8 -8 -8 -8 -8 -8 -8 -8 -8 -8 -8 0 0 0 0 0 0 0 0 0 0 0 0 0 0 0 0 0 0
441 12 12 12 12 12 12 12 12 12 12 12 12 12 12 0 0 12 12 0 0 0 0 0 0 0 0 0 -8 -8 -8 -8 -8 -8 -8 -8 -8 -8 -8 -8 -8 -8 -8 -8 -8 -8 0 0 0 0 0 0 0 0 0 0 0 0 0 0 0 0 0 0
460 12 12 12 12 12 12 12 12 12 12 12 12 12 12 0 12 12 12 0 0 0 0 0 0 0 0 0 -8 -8 -8 -8 -8 -8 -8 -8 -8 -8 -8 -8 -8 -8 -8 -8 -8 -8 0 0 0 0 0 0 0 0 0 0 0 0 0 0 0 0 0 0
470 12 12 12 12 12 12 12 12 12 12 12 12 12 12 0 12 12 12 0 0 12 0 0 0 0 0 0 -8 -8 -8 -8 -8 -8 -8 -8 -8 -8 -8 -8 -8 -8 -8 -8 -8 -8 0 0 0 0 0 0 0 0 0 0 0 0 0 0 0 0 0 0
472 12 12 12 12 12 12 12 12 12 12 12 12 12 12 0 12 12 12 0 0 12 0 0 0 0 12 0 -8 -8 -8 -8 -8 -8 -8 -8 -8 -8 -8 -8 -8 -8 -8 -8 -8 -8 0 0 0 0 0 0 0 0 0 0 0 0 0 0 0 0 0 0
475 12 12 12 12 12 12 12 12 12 12 12 12 12 12 0 12 12 12 0 0 12 0 0 0 0 12 12 -8 -8 -8 -8 -8 -8 -8 -8 -8 -8 -8 -8 -8 -8 -8 -8 -8 -8 0 0 0 0 0 0 0 0 0 0 0 0 0 0 0 0 0 0
484 12 12 12 12 12 12 12 12 12 12 12 12 12 12 0 12 12 12 0 12 12 0 0 0 0 12 12 -8 -8 -8 -8 -8 -8 -8 -8 -8 -8 -8 -8 -8 -8 -8 -8 -8 -8 0 0 0 0 0 0 0 0 0 0 0 0 0 0 0 0 0 0
488 12 12 12 12 12 12 12 12 12 12 12 12 12 12 0 12 12 12 0 12 12 12 0 0 0 12 12 -8 -8 -8 -8 -8 -8 -8 -8 -8 -8 -8 -8 -8 -8 -8 -8 -8 -8 0 0 0 0 0 0 0 0 0 0 0 0 0 0 0 0 0 0
489 12 12 12 12 12 12 12 12 12 12 12 12 12 12 0 12 12 12 0 12 12 0 0 0 0 12 12 -8 -8 -8 -8 -8 -8 -8 -8 -8 -8 -8 -8 -8 -8 -8 -8 -8 -8 0 0 0 0 0 0 0 0 0 0 0 0 0 0 0 0 0 0
492 12 12 12 12 12 12 12 12 12 12 12 12 12 12 0 12 12 12 0 12 12 0 0 0 0 0 0 -8 -8 -8 -8 -8 -8 -8 -8 -8 -8 -8 -8 -8 -8 -8 -8 -8 -8 0 0 0 0 0 0 0 0 0 0 0 0 0 0 0 0 0 0
496 12 12 12 12 12 12 12 12 12 12 12 12 12 12 0 12 12 12 0 0 12 0 0 0 0 0 0 -8 -8 -8 -8 -8 -8 -8 -8 -8 -8 -8 -8 -8 -8 -8 -8 -8 -8 0 0 0 0 0 0 0 0 0 0 0 0 0 0 0 0 0 0
497 12 12 12 12 12 12 12 12 12 12 12 12 12 12 0 12 12 12 0 0 0 0 0 0 0 0 0 -8 -8 -8 -8 -8 -8 -8 -8 -8 -8 -8 -8 -8 -8 -8 -8 -8 -8 0 0 0 0 0 0 0 0 0 0 0 0 0 0 0 0 0 0
508 12 12 12 12 12 12 12 12 12 12 12 12 12 12 12 12 12 12 0 0 0 0 0 0 0 0 0 -8 -8 -8 -8 -8 -8 -8 -8 -8 -8 -8 -8 -8 -8 -8 -8 -8 -8 0 0 0 0 0 0 0 0 0 0 0 0 0 0 0 0 0 0
524 12 12 12 12 12 12 12 12 12 12 12 12 12 12 12 12 12 12 0 0 0 0 0 0 0 12 0 -8 -8 -8 -8 -8 -8 -8 -8 -8 -8 -8 -8 -8 -8 -8 -8 -8 -8 0 0 0 0 0 0 0 0 0 0 0 0 0 0 0 0 0 0
526 12 12 12 12 12 12 12 12 12 12 12 12 12 12 12 12 12 12 0 0 0 0 0 0 0 12 12 -8 -8 -8 -8 -8 -8 -8 -8 -8 -8 -8 -8 -8 -8 -8 -8 -8 -8 0 0 0 0 0 0 0 0 0 0 0 0 0 0 0 0 0 0
528 12 12 12 12 12 12 12 12 12 12 12 12 12 12 12 12 12 12 0 0 0 0 0 0 12 12 12 -8 -8 -8 -8 -8 -8 -8 -8 -8 -8 -8 -8 -8 -8 -8 -8 -8 -8 0 0 0 0 0 0 0 0 0 0 0 0 0 0 0 0 0 0
530 12 12 12 12 12 12 12 12 12 12 12 12 12 12 12 12 12 12 0 0 0 0 0 0 0 12 12 -8 -8 -8 -8 -8 -8 -8 -8 -8 -8 -8 -8 -8 -8 -8 -8 -8 -8 0 0 0 0 0 0 0 0 0 0 0 0 0 0 0 0 0 0
532 12 12 12 12 12 12 12 12 12 12 12 12 12 12 12 12 12 12 0 0 0 0 0 0 0 12 0 -8 -8 -8 -8 -8 -8 -8 -8 -8 -8 -8 -8 -8 -8 -8 -8 -8 -8 0 0 0 0 0 0 0 0 0 0 0 0 0 0 0 0 0 0
533 12 12 12 12 12 12 12 12 12 12 12 12 12 12 12 12 12 12 0 0 0 0 0 0 0 0 0 -8 -8 -8 -8 -8 -8 -8 -8 -8 -8 -8 -8 -8 -8 -8 -8 -8 -8 0 0 0 0 0 0 0 0 0 0 0 0 0 0 0 0 0 0
535 12 12 12 12 12 12 12 12 12 12 12 12 12 12 12 12 12 0 0 0 0 0 0 0 0 0 0 -8 -8 -8 -8 -8 -8 -8 -8 -8 -8 -8 -8 -8 -8 -8 -8 -8 -8 0 0 0 0 0 0 0 0 0 0 0 0 0 0 0 0 0 0
536 12 12 12 12 12 12 12 0 0 12 12 12 12 12 12 0 0 0 0 0 0 0 0 0 0 0 0 -8 -8 -8 -8 -8 -8 -8 -8 -8 -8 -8 -8 -8 -8 -8 -8 -8 -8 0 0 0 0 0 0 0 0 0 0 0 0 0 0 0 0 0 0
538 12 12 12 12 12 12 0 0 0 12 12 12 12 12 12 0 0 0 0 0 0 0 0 0 0 0 0 -8 -8 -8 -8 -8 -8 -8 -8 -8 -8 -8 -8 -8 -8 -8 -8 -8 -8 0 0 0 0 0 0 0 0 0 0 0 0 0 0 0 0 0 0
539 12 12 12 12 12 12 0 0 0 12 12 12 12 12 0 0 0 0 0 0 0 0 0 0 0 0 0 -8 -8 -8 -8 -8 -8 -8 -8 -8 -8 -8 -8 -8 -8 -8 -8 -8 -8 0 0 0 0 0 0 0 0 0 0 0 0 0 0 0 0 0 0
561 12 12 12 12 12 12 12 0 0 12 12 12 12 12 0 0 0 0 0 0 0 0 0 0 0 0 0 -8 -8 -8 -8 -8 -8 -8 -8 -8 -8 -8 -8 -8 -8 -8 -8 -8 -8 0 0 0 0 0 0 0 0 0 0 0 0 0 0 0 0 0 0
563 12 12 12 12 12 12 12 12 12 12 12 12 12 12 0 0 12 12 0 0 0 0 0 0 0 0 0 -8 -8 -8 -8 -8 -8 -8 -8 -8 -8 -8 -8 -8 -8 -8 -8 -8 -8 0 0 0 0 0 0 0 0 0 0 0 0 0 0 0 0 0 0
564 12 12 12 12 12 12 12 12 12 12 12 12 12 12 0 12 12 12 0 0 0 0 0 0 0 0 0 -8 -8 -8 -8 -8 -8 -8 -8 -8 -8 -8 -8 -8 -8 -8 -8 -8 -8 0 0 0 0 0 0 0 0 0 0 0 0 0 0 0 0 0 0
587 12 12 12 12 12 12 12 12 12 12 12 12 12 12 0 0 12 12 0 0 0 0 0 0 0 0 0 -8 -8 -8 -8 -8 -8 -8 -8 -8 -8 -8 -8 -8 -8 -8 -8 -8 -8 0 0 0 0 0 0 0 0 0 0 0 0 0 0 0 0 0 0
614 12 12 12 12 12 12 12 12 12 12 12 12 12 12 0 0 12 12 0 12 0 0 0 0 0 0 0 -8 -8 -8 -8 -8 -8 -8 -8 -8 -8 -8 -8 -8 -8 -8 -8 -8 -8 0 0 0 0 0 0 0 0 0 0 0 0 0 0 0 0 0 0
623 12 12 12 12 12 12 12 12 12 12 12 12 12 12 12 0 12 12 0 12 0 0 0 0 0 0 0 -8 -8 -8 -8 -8 -8 -8 -8 -8 -8 -8 -8 -8 -8 -8 -8 -8 -8 0 0 0 0 0 0 0 0 0 0 0 0 0 0 0 0 0 0
626 12 12 12 12 12 12 12 12 12 12 12 12 12 12 12 0 12 12 0 12 12 0 0 0 0 0 0 -8 -8 -8 -8 -8 -8 -8 -8 -8 -8 -8 -8 -8 -8 -8 -8 -8 -8 0 0 0 0 0 0 0 0 0 0 0 0 0 0 0 0 0 0
630 12 12 12 12 12 12 12 12 12 12 12 12 12 12 12 12 12 12 0 12 12 0 0 0 0 0 0 -8 -8 -8 -8 -8 -8 -8 -8 -8 -8 -8 -8 -8 -8 -8 -8 -8 -8 0 0 0 0 0 0 0 0 0 0 0 0 0 0 0 0 0 0
640 12 12 12 12 12 12 12 12 12 12 12 12 12 12 12 12 12 12 0 0 12 0 0 0 0 0 0 -8 -8 -8 -8 -8 -8 -8 -8 -8 -8 -8 -8 -8 -8 -8 -8 -8 -8 0 0 0 0 0 0 0 0 0 0 0 0 0 0 0 0 0 0
641 12 12 12 12 12 12 12 12 12 12 12 12 12 12 12 12 12 12 0 0 0 0 0 0 0 0 0 -8 -8 -8 -8 -8 -8 -8 -8 -8 -8 -8 -8 -8 -8 -8 -8 -8 -8 0 0 0 0 0 0 0 0 0 0 0 0 0 0 0 0 0 0
657 12 12 12 12 12 12 0 0 0 12 12 12 12 12 12 12 12 12 0 0 0 0 0 0 0 0 0 -8 -8 -8 -8 -8 -8 -8 -8 -8 -8 -8 -8 -8 -8 -8 -8 -8 -8 0 0 0 0 0 0 0 0 0 0 0 0 0 0 0 0 0 0
658 12 12 12 12 12 0 0 0 0 12 12 12 12 12 0 0 0 0 0 0 0 0 0 0 0 0 0 -8 -8 -8 -8 -8 -8 -8 -8 -8 -8 -8 -8 -8 -8 -8 -8 -8 -8 0 0 0 0 0 0 0 0 0 0 0 0 0 0 0 0 0 0
666 12 12 12 12 12 0 0 0 0 12 12 12 12 0 0 0 0 0 0 0 0 0 0 0 0 0 0 -8 -8 -8 -8 -8 -8 -8 -8 -8 -8 -8 -8 -8 -8 -8 -8 -8 -8 0 0 0 0 0 0 0 0 0 0 0 0 0 0 0 0 0 0
676 12 12 12 12 12 0 0 0 0 12 12 12 12 12 0 0 0 0 0 0 0 0 0 0 0 0 0 -8 -8 -8 -8 -8 -8 -8 -8 -8 -8 -8 -8 -8 -8 -8 -8 -8 -8 0 0 0 0 0 0 0 0 0 0 0 0 0 0 0 0 0 0
685 12 12 12 12 12 12 12 12 12 12 12 12 12 12 12 12 12 12 0 0 0 0 0 0 0 0 12 -8 -8 -8 -8 -8 -8 -8 -8 -8 -8 -8 -8 -8 -8 -8 -8 -8 -8 0 0 0 0 0 0 0 0 0 0 0 0 0 0 0 0 0 0
686 12 12 12 12 12 12 12 12 12 12 12 12 12 12 12 12 12 12 0 0 0 0 0 0 0 12 12 -8 -8 -8 -8 -8 -8 -8 -8 -8 -8 -8 -8 -8 -8 -8 -8 -8 -8 0 0 0 0 0 0 0 0 0 0 0 0 0 0 0 0 0 0
688 12 12 12 12 12 12 12 12 12 12 12 12 12 12 12 12 12 12 0 0 0 0 0 0 12 12 12 -8 -8 -8 -8 -8 -8 -8 -8 -8 -8 -8 -8 -8 -8 -8 -8 -8 -8 0 0 0 0 0 0 0 0 0 0 0 0 0 0 0 0 0 0
690 12 12 12 12 12 12 12 12 12 12 12 12 12 12 12 12 12 12 0 0 0 0 0 12 12 12 12 -8 -8 -8 -8 -8 -8 -8 -8 -8 -8 -8 -8 -8 -8 -8 -8 -8 -8 0 0 0 0 0 0 0 0 0 0 0 0 0 0 0 0 0 0
692 12 12 12 12 12 12 12 12 12 12 12 12 12 12 12 12 12 12 0 0 0 0 0 0 12 12 12 -8 -8 -8 -8 -8 -8 -8 -8 -8 -8 -8 -8 -8 -8 -8 -8 -8 -8 0 0 0 0 0 0 0 0 0 0 0 0 0 0 0 0 0 0
695 12 12 12 12 12 12 12 12 12 12 12 12 12 12 12 12 12 12 0 0 0 0 0 0 0 12 12 -8 -8 -8 -8 -8 -8 -8 -8 -8 -8 -8 -8 -8 -8 -8 -8 -8 -8 0 0 0 0 0 0 0 0 0 0 0 0 0 0 0 0 0 0
697 12 12 12 12 12 12 12 12 12 12 12 12 12 12 12 12 12 12 0 0 0 0 0 0 0 0 12 -8 -8 -8 -8 -8 -8 -8 -8 -8 -8 -8 -8 -8 -8 -8 -8 -8 -8 0 0 0 0 0 0 0 0 0 0 0 0 0 0 0 0 0 0
698 12 12 12 12 12 12 0 0 0 12 12 12 12 12 0 0 0 0 0 0 0 0 0 0 0 0 0 -8 -8 -8 -8 -8 -8 -8 -8 -8 -8 -8 -8 -8 -8 -8 -8 -8 -8 0 0 0 0 0 0 0 0 0 0 0 0 0 0 0 0 0 0
699 12 12 12 12 12 12 0 0 0 12 12 12 12 12 0 0 0 0 0 0 0 12 0 0 0 0 0 -8 -8 -8 -8 -8 -8 -8 -8 -8 -8 -8 -8 -8 -8 -8 -8 -8 -8 0 0 0 0 0 0 0 0 0 0 0 0 0 0 0 0 0 0
711 12 12 12 12 12 0 0 0 0 12 12 12 12 12 0 0 0 0 0 0 0 12 0 0 0 0 0 -8 -8 -8 -8 -8 -8 -8 -8 -8 -8 -8 -8 -8 -8 -8 -8 -8 -8 0 0 0 0 0 0 0 0 0 0 0 0 0 0 0 0 0 0
720 12 12 12 12 12 0 0 0 0 12 12 12 12 0 0 0 0 0 0 0 0 12 0 0 0 0 0 -8 -8 -8 -8 -8 -8 -8 -8 -8 -8 -8 -8 -8 -8 -8 -8 -8 -8 0 0 0 0 0 0 0 0 0 0 0 0 0 0 0 0 0 0
727 12 12 12 12 12 0 0 0 0 12 12 12 12 0 0 0 0 0 0 0 12 12 0 0 0 0 0 -8 -8 -8 -8 -8 -8 -8 -8 -8 -8 -8 -8 -8 -8 -8 -8 -8 -8 0 0 0 0 0 0 0 0 0 0 0 0 0 0 0 0 0 0
739 12 12 12 12 12 0 0 0 0 12 12 12 12 12 0 0 0 0 0 0 12 12 0 0 0 0 0 -8 -8 -8 -8 -8 -8 -8 -8 -8 -8 -8 -8 -8 -8 -8 -8 -8 -8 0 0 0 0 0 0 0 0 0 0 0 0 0 0 0 0 0 0
741 12 12 12 12 12 12 0 0 0 12 12 12 12 12 0 0 0 0 0 0 12 12 0 0 0 0 0 -8 -8 -8 -8 -8 -8 -8 -8 -8 -8 -8 -8 -8 -8 -8 -8 -8 -8 0 0 0 0 0 0 0 0 0 0 0 0 0 0 0 0 0 0
746 12 12 12 12 12 12 12 12 12 12 12 12 12 12 12 12 12 12 0 0 12 12 0 0 0 12 12 -8 -8 -8 -8 -8 -8 -8 -8 -8 -8 -8 -8 -8 -8 -8 -8 -8 -8 0 0 0 0 0 0 0 0 0 0 0 0 0 0 0 0 0 0
747 12 12 12 12 12 12 12 12 12 12 12 12 12 12 12 12 12 12 0 0 12 12 0 0 12 12 12 -8 -8 -8 -8 -8 -8 -8 -8 -8 -8 -8 -8 -8 -8 -8 -8 -8 -8 0 0 0 0 0 0 0 0 0 0 0 0 0 0 0 0 0 0
749 12 12 12 12 12 12 12 12 12 12 12 12 12 12 12 12 12 12 0 0 12 12 0 12 12 12 12 -8 -8 -8 -8 -8 -8 -8 -8 -8 -8 -8 -8 -8 -8 -8 -8 -8 -8 0 0 0 0 0 0 0 0 0 0 0 0 0 0 0 0 0 0
752 12 12 12 12 12 12 12 12 12 12 12 12 12 12 12 12 12 12 0 0 12 12 12 12 12 12 12 -8 -8 -8 -8 -8 -8 -8 -8 -8 -8 -8 -8 -8 -8 -8 -8 -8 -8 0 0 0 0 0 0 0 0 0 0 0 0 0 0 0 0 0 0
753 12 12 12 12 12 12 12 12 12 12 12 12 12 12 12 12 12 12 0 0 12 12 0 12 12 12 12 -8 -8 -8 -8 -8 -8 -8 -8 -8 -8 -8 -8 -8 -8 -8 -8 -8 -8 0 0 0 0 0 0 0 0 0 0 0 0 0 0 0 0 0 0
755 12 12 12 12 12 12 12 12 12 12 12 12 12 12 12 12 12 12 0 0 12 12 0 0 12 12 12 -8 -8 -8 -8 -8 -8 -8 -8 -8 -8 -8 -8 -8 -8 -8 -8 -8 -8 0 0 0 0 0 0 0 0 0 0 0 0 0 0 0 0 0 0
758 12 12 12 12 12 12 12 12 12 12 12 12 12 12 12 12 12 12 0 12 12 12 0 0 0 12 12 -8 -8 -8 -8 -8 -8 -8 -8 -8 -8 -8 -8 -8 -8 -8 -8 -8 -8 0 0 0 0 0 0 0 0 0 0 0 0 0 0 0 0 0 0
759 12 12 12 12 12 12 0 0 0 12 12 12 12 12 0 0 0 0 0 12 12 12 0 0 0 0 0 -8 -8 -8 -8 -8 -8 -8 -8 -8 -8 -8 -8 -8 -8 -8 -8 -8 -8 0 0 0 0 0 0 0 0 0 0 0 0 0 0 0 0 0 0
767 12 12 12 12 12 0 0 0 0 12 12 12 12 12 0 0 0 0 0 12 12 12 0 0 0 0 0 -8 -8 -8 -8 -8 -8 -8 -8 -8 -8 -8 -8 -8 -8 -8 -8 -8 -8 0 0 0 0 0 0 0 0 0 0 0 0 0 0 0 0 0 0
778 12 12 12 12 12 12 0 0 0 12 12 12 12 12 0 0 0 0 0 12 12 12 0 0 0 0 0 -8 -8 -8 -8 -8 -8 -8 -8 -8 -8 -8 -8 -8 -8 -8 -8 -8 -8 0 0 0 0 0 0 0 0 0 0 0 0 0 0 0 0 0 0
780 12 12 12 12 12 12 0 0 0 12 12 12 12 12 0 0 0 0 12 12 12 12 0 0 0 0 0 -8 -8 -8 -8 -8 -8 -8 -8 -8 -8 -8 -8 -8 -8 -8 -8 -8 -8 0 0 0 0 0 0 0 0 0 0 0 0 0 0 0 0 0 0
786 12 12 12 12 12 12 12 12 12 12 12 12 12 12 0 12 12 12 12 12 12 12 0 0 0 0 0 -8 -8 -8 -8 -8 -8 -8 -8 -8 -8 -8 -8 -8 -8 -8 -8 -8 -8 0 0 0 0 0 0 0 0 0 0 0 0 0 0 0 0 0 0
787 12 12 12 12 12 12 12 12 12 12 12 12 12 12 12 12 12 12 12 12 12 12 0 0 0 0 0 -8 -8 -8 -8 -8 -8 -8 -8 -8 -8 -8 -8 -8 -8 -8 -8 -8 -8 0 0 0 0 0 0 0 0 0 0 0 0 0 0 0 0 0 0
788 12 12 12 12 12 12 12 12 12 12 12 12 12 12 12 12 12 12 12 12 12 12 0 0 0 12 0 -8 -8 -8 -8 -8 -8 -8 -8 -8 -8 -8 -8 -8 -8 -8 -8 -8 -8 0 0 0 0 0 0 0 0 0 0 0 0 0 0 0 0 0 0
789 12 12 12 12 12 12 12 12 12 12 12 12 12 12 12 12 12 12 12 12 12 12 0 0 0 12 12 -8 -8 -8 -8 -8 -8 -8 -8 -8 -8 -8 -8 -8 -8 -8 -8 -8 -8 0 0 0 0 0 0 0 0 0 0 0 0 0 0 0 0 0 0
803 12 12 12 12 12 12 12 12 12 12 12 12 12 12 12 12 12 12 12 12 12 0 0 0 0 12 12 -8 -8 -8 -8 -8 -8 -8 -8 -8 -8 -8 -8 -8 -8 -8 -8 -8 -8 0 0 0 0 0 0 0 0 0 0 0 0 0 0 0 0 0 0
804 12 12 12 12 12 12 12 12 12 12 12 12 12 12 12 12 12 12 12 12 0 0 0 0 0 12 12 -8 -8 -8 -8 -8 -8 -8 -8 -8 -8 -8 -8 -8 -8 -8 -8 -8 -8 0 0 0 0 0 0 0 0 0 0 0 0 0 0 0 0 0 0
814 12 12 12 12 12 12 12 12 12 12 12 12 12 12 12 12 12 12 12 0 0 0 0 0 0 12 12 -8 -8 -8 -8 -8 -8 -8 -8 -8 -8 -8 -8 -8 -8 -8 -8 -8 -8 0 0 0 0 0 0 0 0 0 0 0 0 0 0 0 0 0 0
820 12 12 12 12 12 12 12 12 12 12 12 12 12 12 12 12 12 12 0 0 0 0 0 0 0 12 12 -8 -8 -8 -8 -8 -8 -8 -8 -8 -8 -8 -8 -8 -8 -8 -8 -8 -8 0 0 0 0 0 0 0 0 0 0 0 0 0 0 0 0 0 0
864 12 12 12 12 12 12 12 12 12 12 12 12 12 12 12 12 12 12 0 0 0 0 0 0 0 0 12 -8 -8 -8 -8 -8 -8 -8 -8 -8 -8 -8 -8 -8 -8 -8 -8 -8 -8 0 0 0 0 0 0 0 0 0 0 0 0 0 0 0 0 0 0
877 12 12 12 12 12 12 12 12 12 12 12 12 12 12 12 12 12 12 0 0 0 0 0 0 0 0 0 -8 -8 -8 -8 -8 -8 -8 -8 -8 -8 -8 -8 -8 -8 -8 -8 -8 -8 0 0 0 0 0 0 0 0 0 0 0 0 0 0 0 0 0 0
881 12 12 12 12 12 12 12 12 12 12 12 12 12 12 12 0 12 12 0 0 0 0 0 0 0 0 0 -8 -8 -8 -8 -8 -8 -8 -8 -8 -8 -8 -8 -8 -8 -8 -8 -8 -8 0 0 0 0 0 0 0 0 0 0 0 0 0 0 0 0 0 0
892 12 12 12 12 12 12 12 12 12 12 12 12 12 12 12 0 12 12 0 0 0 0 0 0 0 0 0 0 -8 -8 -8 -8 -8 -8 -8 -8 -8 -8 -8 -8 -8 -8 -8 -8 -8 0 0 0 0 0 0 0 0 0 0 0 0 0 0 0 0 0 0
893 12 12 12 12 12 12 12 12 12 12 12 12 12 12 12 0 12 12 0 0 0 0 0 0 0 0 0 0 -8 -8 -8 -8 -8 -8 -8 0 -8 -8 -8 -8 -8 -8 -8 -8 -8 0 0 0 0 0 0 0 0 0 0 0 0 0 0 0 0 0 0
894 12 12 12 12 12 12 12 12 12 12 12 12 12 12 12 0 0 12 0 0 0 0 0 0 0 0 0 0 -8 -8 -8 -8 -8 -8 -8 0 -8 -8 -8 -8 -8 -8 -8 -8 -8 0 0 0 0 0 0 0 0 0 0 0 0 0 0 0 0 0 0
896 12 12 12 12 12 12 12 12 12 12 12 12 12 12 12 0 0 12 0 0 0 0 0 0 0 0 0 0 -8 -8 -8 -8 -8 -8 -8 -8 -8 -8 -8 -8 -8 -8 -8 -8 -8 0 0 0 0 0 0 0 0 0 0 0 0 0 0 0 0 0 0
897 12 12 12 12 12 12 12 12 12 12 12 12 12 12 12 0 0 12 0 0 0 0 0 0 0 0 0 -8 -8 -8 -8 -8 -8 -8 -8 -8 -8 -8 -8 -8 -8 -8 -8 -8 -8 0 0 0 0 0 0 0 0 0 0 0 0 0 0 0 0 0 0
910 12 12 12 12 12 12 12 12 12 12 12 12 12 12 12 0 0 12 0 0 0 0 0 0 0 -8 -8 -8 -8 -8 -8 -8 -8 -8 -8 -8 -8 -8 -8 -8 -8 -8 -8 -8 -8 0 0 0 0 0 0 0 0 0 0 0 0 0 0 0 0 0 0
921 12 12 12 12 12 12 12 12 12 12 12 12 12 12 12 0 0 0 0 0 0 0 0 0 0 0 -8 -8 -8 -8 -8 -8 -8 -8 -8 -8 -8 -8 -8 -8 -8 -8 -8 -8 -8 0 0 0 0 0 0 0 0 0 0 0 0 0 0 0 0 0 0
938 12 12 12 12 12 12 12 12 12 12 12 12 12 12 12 0 0 0 0 0 0 0 0 0 0 0 0 -8 -8 -8 -8 -8 -8 -8 -8 -8 -8 -8 -8 -8 -8 -8 -8 -8 -8 0 0 0 0 0 0 0 0 0 0 0 0 0 0 0 0 0 0
941 12 12 12 12 12 12 12 0 12 12 12 12 12 12 12 0 0 0 0 0 0 0 0 0 0 0 0 -8 -8 -8 -8 -8 -8 -8 -8 -8 -8 -8 -8 -8 -8 -8 -8 -8 -8 0 0 0 0 0 0 0 0 0 0 0 0 0 0 0 0 0 0
942 12 12 12 12 12 12 12 0 0 12 12 12 12 12 12 0 0 0 0 0 0 0 0 0 0 0 0 -8 -8 -8 -8 -8 -8 -8 -8 -8 -8 -8 -8 -8 -8 -8 -8 -8 -8 0 0 0 0 0 0 0 0 0 0 0 0 0 0 0 0 0 0
969 12 12 12 12 12 12 12 12 12 12 12 12 12 12 12 0 0 0 0 0 0 0 0 0 0 0 0 -8 -8 -8 -8 -8 -8 -8 -8 -8 -8 -8 -8 -8 -8 -8 -8 -8 -8 0 0 0 0 0 0 0 0 0 0 0 0 0 0 0 0 0 0
970 12 12 12 12 12 12 12 12 12 12 12 12 12 12 12 0 0 12 0 0 0 0 0 0 0 0 0 -8 -8 -8 -8 -8 -8 -8 -8 -8 -8 -8 -8 -8 -8 -8 -8 -8 -8 0 0 0 0 0 0 0 0 0 0 0 0 0 0 0 0 0 0
983 12 12 12 12 12 12 12 12 12 12 12 12 12 12 0 0 0 12 0 0 0 0 0 0 0 0 0 -8 -8 -8 -8 -8 -8 -8 -8 -8 -8 -8 -8 -8 -8 -8 -8 -8 -8 0 0 0 0 0 0 0 0 0 0 0 0 0 0 0 0 0 0
990 12 12 12 12 12 12 12 12 12 12 12 12 12 12 0 0 0 0 0 0 0 0 0 0 0 0 0 -8 -8 -8 -8 -8 -8 -8 -8 -8 -8 -8 -8 -8 -8 -8 -8 -8 -8 0 0 0 0 0 0 0 0 0 0 0 0 0 0 0 0 0 0
1017 12 12 12 12 12 12 12 12 12 12 12 12 12 0 0 0 0 0 0 0 0 0 0 0 0 0 0 -8 -8 -8 -8 -8 -8 -8 -8 -8 -8 -8 -8 -8 -8 -8 -8 -8 -8 0 0 0 0 0 0 0 0 0 0 0 0 0 0 0 0 0 0
1020 12 12 12 12 12 12 12 12 12 12 12 12 12 0 0 0 12 0 0 0 0 0 0 0 0 0 0 -8 -8 -8 -8 -8 -8 -8 -8 -8 -8 -8 -8 -8 -8 -8 -8 -8 -8 0 0 0 0 0 0 0 0 0 0 0 0 0 0 0 0 0 0
1022 12 12 12 12 12 12 12 12 12 12 12 12 12 0 0 0 12 12 0 0 0 0 0 0 0 0 0 -8 -8 -8 -8 -8 -8 -8 -8 -8 -8 -8 -8 -8 -8 -8 -8 -8 -8 0 0 0 0 0 0 0 0 0 0 0 0 0 0 0 0 0 0
1029 12 12 12 12 12 12 12 12 12 12 12 12 0 0 0 0 12 12 0 0 0 0 0 0 0 0 0 -8 -8 -8 -8 -8 -8 -8 -8 -8 -8 -8 -8 -8 -8 -8 -8 -8 -8 0 0 0 0 0 0 0 0 0 0 0 0 0 0 0 0 0 0
1031 12 12 12 12 12 12 12 12 12 12 12 0 0 0 0 0 12 12 0 0 0 0 0 0 0 0 0 -8 -8 -8 -8 -8 -8 -8 -8 -8 -8 -8 -8 -8 -8 -8 -8 -8 -8 0 0 0 0 0 0 0 0 0 0 0 0 0 0 0 0 0 0
1041 12 12 12 12 12 12 12 12 12 12 12 0 12 12 0 0 0 12 0 0 0 0 0 0 0 0 0 -8 -8 -8 -8 -8 -8 -8 -8 -8 -8 -8 -8 -8 -8 -8 -8 -8 -8 0 0 0 0 0 0 0 0 0 0 0 0 0 0 0 0 0 0
1042 12 12 12 12 12 12 12 12 12 12 12 0 12 12 0 0 0 0 0 0 0 0 0 0 0 0 0 -8 -8 -8 -8 -8 -8 -8 -8 -8 -8 -8 -8 -8 -8 -8 -8 -8 -8 0 0 0 0 0 0 0 0 0 0 0 0 0 0 0 0 0 0
1043 12 12 12 12 12 12 12 12 0 12 12 12 12 12 0 0 0 0 0 0 0 0 0 0 0 0 0 -8 -8 -8 -8 -8 -8 -8 -8 -8 -8 -8 -8 -8 -8 -8 -8 -8 -8 0 0 0 0 0 0 0 0 0 0 0 0 0 0 0 0 0 0
1044 12 12 12 12 12 12 0 0 0 12 12 12 12 12 0 0 0 0 0 0 0 0 0 0 0 0 0 -8 -8 -8 -8 -8 -8 -8 -8 -8 -8 -8 -8 -8 -8 -8 -8 -8 -8 0 0 0 0 0 0 0 0 0 0 0 0 0 0 0 0 0 0
1076 12 12 12 12 12 0 0 0 0 12 12 12 12 12 0 0 0 0 0 0 0 0 0 0 0 0 0 -8 -8 -8 -8 -8 -8 -8 -8 -8 -8 -8 -8 -8 -8 -8 -8 -8 -8 0 0 0 0 0 0 0 0 0 0 0 0 0 0 0 0 0 0
1079 12 12 12 12 12 12 0 0 0 12 12 12 12 12 0 0 0 0 0 0 0 0 0 0 0 0 0 -8 -8 -8 -8 -8 -8 -8 -8 -8 -8 -8 -8 -8 -8 -8 -8 -8 -8 0 0 0 0 0 0 0 0 0 0 0 0 0 0 0 0 0 0
1087 12 12 12 12 12 12 0 0 0 12 12 12 12 12 0 0 0 0 0 0 0 0 0 -8 0 0 0 -8 -8 -8 -8 -8 -8 -8 -8 -8 -8 -8 -8 -8 -8 -8 -8 -8 -8 0 0 0 0 0 0 0 0 0 0 0 0 0 0 0 0 0 0
1091 12 12 12 12 12 12 12 12 12 12 12 12 12 12 0 0 0 12 0 0 0 0 0 -8 0 0 0 -8 -8 -8 -8 -8 -8 -8 -8 -8 -8 -8 -8 -8 -8 -8 -8 -8 -8 0 0 0 0 0 0 0 0 0 0 0 0 0 0 0 0 0 0
1092 12 12 12 12 12 12 12 12 12 12 12 12 12 12 0 0 12 12 0 0 0 0 0 -8 0 0 0 -8 -8 -8 -8 -8 -8 -8 -8 -8 -8 -8 -8 -8 -8 -8 -8 -8 -8 0 0 0 0 0 0 0 0 0 0 0 0 0 0 0 0 0 0
1103 12 12 12 12 12 12 12 12 12 12 12 12 12 12 0 0 0 12 0 0 0 0 0 -8 0 0 0 -8 -8 -8 -8 -8 -8 -8 -8 -8 -8 -8 -8 -8 -8 -8 -8 -8 -8 0 0 0 0 0 0 0 0 0 0 0 0 0 0 0 0 0 0
1104 12 12 12 12 12 12 12 12 12 12 12 12 12 12 0 0 0 0 0 0 0 0 0 -8 0 0 0 -8 -8 -8 -8 -8 -8 -8 -8 -8 -8 -8 -8 -8 -8 -8 -8 -8 -8 0 0 0 0 0 0 0 0 0 0 0 0 0 0 0 0 0 0
1105 12 12 12 12 12 12 12 0 0 12 12 12 12 12 0 0 0 0 0 0 0 0 0 -8 0 0 0 -8 -8 -8 -8 -8 -8 -8 -8 -8 -8 -8 -8 -8 -8 -8 -8 -8 -8 0 0 0 0 0 0 0 0 0 0 0 0 0 0 0 0 0 0
1106 12 12 12 12 12 12 12 0 0 12 12 12 12 12 0 0 0 0 0 0 0 0 0 0 0 0 0 -8 -8 -8 -8 -8 -8 -8 -8 -8 -8 -8 -8 -8 -8 -8 -8 -8 -8 0 0 0 0 0 0 0 0 0 0 0 0 0 0 0 0 0 0
1112 12 12 12 12 12 12 0 0 0 12 12 12 12 12 0 0 0 0 0 0 0 0 0 0 0 0 0 -8 -8 -8 -8 -8 -8 -8 -8 -8 -8 -8 -8 -8 -8 -8 -8 -8 -8 0 0 0 0 0 0 0 0 0 0 0 0 0 0 0 0 0 0
1129 12 12 12 12 12 0 0 0 0 12 12 12 12 12 0 0 0 0 0 0 0 0 0 0 0 0 0 -8 -8 -8 -8 -8 -8 -8 -8 -8 -8 -8 -8 -8 -8 -8 -8 -8 -8 0 0 0 0 0 0 0 0 0 0 0 0 0 0 0 0 0 0
1151 12 12 12 12 12 12 0 0 0 12 12 12 12 12 0 0 0 0 0 0 0 0 0 0 0 0 0 -8 -8 -8 -8 -8 -8 -8 -8 -8 -8 -8 -8 -8 -8 -8 -8 -8 -8 0 0 0 0 0 0 0 0 0 0 0 0 0 0 0 0 0 0
1152 12 12 12 12 12 12 0 12 12 12 12 12 12 12 0 0 0 12 0 0 0 0 0 0 0 0 0 -8 -8 -8 -8 -8 -8 -8 -8 -8 -8 -8 -8 -8 -8 -8 -8 -8 -8 0 0 0 0 0 0 0 0 0 0 0 0 0 0 0 0 0 0
1157 12 12 12 12 12 12 12 12 12 12 12 12 12 12 0 0 12 12 0 0 0 0 0 0 0 0 0 -8 -8 -8 -8 -8 -8 -8 -8 -8 -8 -8 -8 -8 -8 -8 -8 -8 -8 0 0 0 0 0 0 0 0 0 0 0 0 0 0 0 0 0 0
1160 12 12 12 12 12 12 0 12 12 12 12 12 12 12 0 0 12 12 0 0 0 0 0 0 0 0 0 -8 -8 -8 -8 -8 -8 -8 -8 -8 -8 -8 -8 -8 -8 -8 -8 -8 -8 0 0 0 0 0 0 0 0 0 0 0 0 0 0 0 0 0 0
1161 12 12 12 12 12 12 0 12 12 12 12 12 12 12 0 0 0 12 0 0 0 0 0 0 0 0 0 -8 -8 -8 -8 -8 -8 -8 -8 -8 -8 -8 -8 -8 -8 -8 -8 -8 -8 0 0 0 0 0 0 0 0 0 0 0 0 0 0 0 0 0 0
1165 12 12 12 12 12 0 0 12 0 12 12 12 12 12 0 0 0 0 0 0 0 0 0 0 0 0 0 -8 -8 -8 -8 -8 -8 -8 -8 -8 -8 -8 -8 -8 -8 -8 -8 -8 -8 0 0 0 0 0 0 0 0 0 0 0 0 0 0 0 0 0 0
1166 12 12 12 12 12 0 0 0 0 12 12 12 12 12 0 0 0 0 0 0 0 0 0 0 0 0 0 -8 -8 -8 -8 -8 -8 -8 -8 -8 -8 -8 -8 -8 -8 -8 -8 -8 -8 0 0 0 0 0 0 0 0 0 0 0 0 0 0 0 0 0 0
1180 12 12 12 12 12 0 0 0 0 12 12 12 12 12 0 0 0 0 0 0 0 0 0 0 0 -8 -8 -8 -8 -8 -8 -8 -8 -8 -8 -8 -8 -8 -8 -8 -8 -8 -8 -8 -8 0 0 0 0 0 0 0 0 0 0 0 0 0 0 0 0 0 0
1190 12 12 12 12 12 12 0 0 0 12 12 12 12 12 0 0 0 0 0 0 0 0 0 0 0 -8 -8 -8 -8 -8 -8 -8 -8 -8 -8 -8 -8 -8 -8 -8 -8 -8 -8 -8 -8 0 0 0 0 0 0 0 0 0 0 0 0 0 0 0 0 0 0
1193 12 12 12 12 12 12 12 12 12 12 12 12 12 12 0 0 0 0 0 0 0 0 0 0 0 -8 -8 -8 -8 -8 -8 -8 -8 -8 -8 -8 -8 -8 -8 -8 -8 -8 -8 -8 -8 0 0 0 0 0 0 0 0 0 0 0 0 0 0 0 0 0 0
1198 12 12 12 12 12 12 12 12 12 12 12 12 12 12 0 0 12 0 0 0 0 0 0 0 0 -8 -8 -8 -8 -8 -8 -8 -8 -8 -8 -8 -8 -8 -8 -8 -8 -8 -8 -8 -8 0 0 0 0 0 0 0 0 0 0 0 0 0 0 0 0 0 0
1199 12 12 12 12 12 12 12 12 12 12 12 12 12 12 0 0 12 12 0 0 0 0 0 0 0 -8 -8 -8 -8 -8 -8 -8 -8 -8 -8 -8 -8 -8 -8 -8 -8 -8 -8 -8 -8 0 0 0 0 0 0 0 0 0 0 0 0 0 0 0 0 0 0
