0 8 8 8 8 8 8 8 8 8 8 8 8 8 8 8 8 0 0 0 0 0 0 0 0 0 0 0 -16 -16 -16 -16 -16 -16 -16 -16 -16 -16 -16 -16 -16 -16 -16 -16 -16 -16 0 0 0 0 0 0 0 0 0 0 0 0 0 0 0 0 0 0
41 8 8 8 8 8 8 8 8 8 8 8 8 8 8 8 8 8 0 0 0 0 0 0 0 0 0 -16 -16 -16 -16 -16 -16 -16 -16 -16 -16 -16 -16 -16 -16 -16 -16 -16 -16 -16 0 0 0 0 0 0 0 0 0 0 0 0 0 0 0 0 0 0
42 8 8 8 8 8 8 8 8 8 8 8 8 8 8 8 8 0 0 0 0 0 0 0 0 0 0 0 -16 -16 -16 -16 -16 -16 -16 -16 -16 -16 -16 -16 -16 -16 -16 -16 -16 -16 0 0 0 0 0 0 0 0 0 0 0 0 0 0 0 0 0 0
57 8 8 8 8 8 8 8 8 8 8 8 8 8 8 8 8 0 0 8 0 0 0 0 0 0 0 0 -16 -16 -16 -16 -16 -16 -16 -16 -16 -16 -16 -16 -16 -16 -16 -16 -16 -16 0 0 0 0 0 0 0 0 0 0 0 0 0 0 0 0 0 0
63 8 8 8 8 8 8 8 8 8 8 8 8 8 8 8 8 0 0 0 0 0 0 0 0 0 0 0 -16 -16 -16 -16 -16 -16 -16 -16 -16 -16 -16 -16 -16 -16 -16 -16 -16 -16 0 0 0 0 0 0 0 0 0 0 0 0 0 0 0 0 0 0
84 8 8 8 8 8 8 8 8 8 0 8 8 8 8 8 8 0 0 0 0 0 0 0 0 0 0 0 -16 -16 -16 -16 -16 -16 -16 -16 -16 -16 -16 -16 -16 -16 -16 -16 -16 -16 0 0 0 0 0 0 0 0 0 0 0 0 0 0 0 0 0 0
87 8 8 8 8 8 8 8 8 8 0 8 8 8 8 8 8 8 0 0 0 0 0 0 0 0 0 0 -16 -16 -16 -16 -16 -16 -16 -16 -16 -16 -16 -16 -16 -16 -16 -16 -16 -16 0 0 0 0 0 0 0 0 0 0 0 0 0 0 0 0 0 0
89 8 8 8 8 8 8 8 8 8 0 0 8 8 8 8 8 8 0 0 0 0 0 0 0 0 0 0 -16 -16 -16 -16 -16 -16 -16 -16 -16 -16 -16 -16 -16 -16 -16 -16 -16 -16 0 0 0 0 0 0 0 0 0 0 0 0 0 0 0 0 0 0
111 8 8 8 8 8 8 8 8 8 0 0 8 8 8 8 8 0 0 0 0 0 0 0 0 0 0 0 -16 -16 -16 -16 -16 -16 -16 -16 -16 -16 -16 -16 -16 -16 -16 -16 -16 -16 0 0 0 0 0 0 0 0 0 0 0 0 0 0 0 0 0 0
115 8 8 8 8 8 8 8 8 8 0 8 8 8 8 8 8 0 0 0 0 0 0 0 0 0 -16 0 -16 -16 -16 -16 -16 -16 -16 -16 -16 -16 -16 -16 -16 -16 -16 -16 -16 -16 0 0 0 0 0 0 0 0 0 0 0 0 0 0 0 0 0 0
120 8 8 8 8 8 8 8 8 8 8 8 8 8 8 8 8 0 0 0 0 0 0 0 0 0 -16 -16 -16 -16 -16 -16 -16 -16 -16 -16 -16 -16 -16 -16 -16 -16 -16 -16 -16 -16 0 0 0 0 0 0 0 0 0 0 0 0 0 0 0 0 0 0
125 8 8 8 8 8 8 8 8 8 8 8 8 8 8 8 8 0 0 0 0 0 0 0 0 0 -16 0 -16 -16 -16 -16 -16 -16 -16 -16 -16 -16 -16 -16 -16 -16 -16 -16 -16 -16 0 0 0 0 0 0 0 0 0 0 0 0 0 0 0 0 0 0
127 8 8 8 8 8 8 8 8 8 8 8 8 8 8 8 8 0 0 0 0 0 0 0 0 0 0 0 -16 -16 -16 -16 -16 -16 -16 -16 -16 -16 -16 -16 -16 -16 -16 -16 -16 -16 0 0 0 0 0 0 0 0 0 0 0 0 0 0 0 0 0 0
130 8 8 8 8 8 8 8 8 8 0 8 8 8 8 8 8 0 0 0 0 0 0 0 0 0 0 0 -16 -16 -16 -16 -16 -16 -16 -16 -16 -16 -16 -16 -16 -16 -16 -16 -16 -16 0 0 0 0 0 0 0 0 0 0 0 0 0 0 0 0 0 0
138 8 8 8 8 8 8 8 8 8 0 8 8 8 8 8 8 0 0 0 0 0 0 -16 0 0 0 0 -16 -16 -16 -16 -16 -16 -16 -16 -16 -16 -16 -16 -16 -16 -16 -16 -16 -16 0 0 0 0 0 0 0 0 0 0 0 0 0 0 0 0 0 0
150 8 8 8 8 8 8 8 8 8 8 8 8 8 8 8 8 0 0 0 0 0 0 -16 0 0 0 0 -16 -16 -16 -16 -16 -16 -16 -16 -16 -16 -16 -16 -16 -16 -16 -16 -16 -16 0 0 0 0 0 0 0 0 0 0 0 0 0 0 0 0 0 0
152 8 8 8 8 8 8 8 8 8 8 8 8 8 8 8 8 0 0 0 0 0 0 0 0 0 0 0 -16 -16 -16 -16 -16 -16 -16 -16 -16 -16 -16 -16 -16 -16 -16 -16 -16 -16 0 0 0 0 0 0 0 0 0 0 0 0 0 0 0 0 0 0
155 8 8 8 8 8 8 8 8 8 8 8 8 8 8 8 8 0 0 0 0 0 0 0 0 -16 0 0 -16 -16 -16 -16 -16 -16 -16 -16 -16 -16 -16 -16 -16 -16 -16 -16 -16 -16 0 0 0 0 0 0 0 0 0 0 0 0 0 0 0 0 0 0
166 8 8 8 8 8 8 8 8 8 8 8 8 8 8 8 8 0 0 0 0 0 0 0 0 0 0 0 -16 -16 -16 -16 -16 -16 -16 -16 -16 -16 -16 -16 -16 -16 -16 -16 -16 -16 0 0 0 0 0 0 0 0 0 0 0 0 0 0 0 0 0 0
169 8 8 8 8 8 8 8 8 8 8 8 8 8 8 8 8 8 0 0 0 0 0 0 0 0 0 0 -16 -16 -16 -16 -16 -16 -16 -16 -16 -16 -16 -16 -16 -16 -16 -16 -16 -16 0 0 0 0 0 0 0 0 0 0 0 0 0 0 0 0 0 0
175 8 8 8 8 8 8 8 8 8 8 8 8 8 8 8 8 8 8 0 0 0 0 0 0 0 0 0 -16 -16 -16 -16 -16 -16 -16 -16 -16 -16 -16 -16 -16 -16 -16 -16 -16 -16 0 0 0 0 0 0 0 0 0 0 0 0 0 0 0 0 0 0
220 8 8 8 8 8 8 8 8 8 8 8 8 8 0 8 8 8 8 0 0 0 0 -16 0 0 0 0 -16 -16 -16 -16 -16 -16 -16 -16 -16 -16 -16 -16 -16 -16 -16 -16 -16 -16 0 0 0 0 0 0 0 0 0 0 0 0 0 0 0 0 0 0
225 8 8 8 8 8 8 8 8 8 8 8 8 8 0 0 8 8 8 0 0 0 0 -16 0 0 0 0 -16 -16 -16 -16 -16 -16 -16 -16 -16 -16 -16 -16 -16 -16 -16 -16 -16 -16 0 0 0 0 0 0 0 0 0 0 0 0 0 0 0 0 0 0
228 8 8 8 8 8 8 8 8 8 8 8 8 8 0 0 0 8 8 0 0 0 0 -16 0 0 0 0 -16 -16 -16 -16 -16 -16 -16 -16 -16 -16 -16 -16 -16 -16 -16 -16 -16 -16 0 0 0 0 0 0 0 0 0 0 0 0 0 0 0 0 0 0
231 8 8 8 8 8 8 8 8 8 8 8 8 8 0 0 0 0 8 0 0 0 0 -16 0 0 0 0 -16 -16 -16 -16 -16 -16 -16 -16 -16 -16 -16 -16 -16 -16 -16 -16 -16 -16 0 0 0 0 0 0 0 0 0 0 0 0 0 0 0 0 0 0
239 8 8 8 8 8 8 8 8 8 8 8 8 8 0 0 0 0 0 0 0 0 0 -16 0 0 0 0 -16 -16 -16 -16 -16 -16 -16 -16 -16 -16 -16 -16 -16 -16 -16 -16 -16 -16 0 0 0 0 0 0 0 0 0 0 0 0 0 0 0 0 0 0
246 8 8 8 8 8 0 8 8 8 8 8 8 8 0 0 0 0 0 0 0 0 0 -16 0 0 0 0 -16 -16 -16 -16 -16 -16 -16 -16 -16 -16 -16 -16 -16 -16 -16 -16 -16 -16 0 0 0 0 0 0 0 0 0 0 0 0 0 0 0 0 0 0
247 8 8 8 8 8 0 0 8 8 8 8 8 8 0 0 0 0 0 0 0 0 0 -16 0 0 0 0 -16 -16 -16 -16 -16 -16 -16 -16 -16 -16 -16 -16 -16 -16 -16 -16 -16 -16 0 0 0 0 0 0 0 0 0 0 0 0 0 0 0 0 0 0
251 8 8 8 8 8 0 0 0 0 8 8 8 8 0 0 0 0 0 0 0 0 0 -16 0 0 0 0 -16 -16 -16 -16 -16 -16 -16 -16 -16 -16 -16 -16 -16 -16 -16 -16 -16 -16 0 0 0 0 0 0 0 0 0 0 0 0 0 0 0 0 0 0
261 8 8 8 8 8 0 0 0 0 8 8 8 8 0 0 0 0 0 0 0 0 0 0 0 0 0 0 -16 -16 -16 -16 -16 -16 -16 -16 -16 -16 -16 -16 -16 -16 -16 -16 -16 -16 0 0 0 0 0 0 0 0 0 0 0 0 0 0 0 0 0 0
264 8 8 8 8 8 0 0 0 0 8 8 8 8 8 0 0 0 0 0 0 0 0 0 0 0 0 0 -16 -16 -16 -16 -16 -16 -16 -16 -16 -16 -16 -16 -16 -16 -16 -16 -16 -16 0 0 0 0 0 0 0 0 0 0 0 0 0 0 0 0 0 0
270 8 8 8 8 8 0 0 0 0 8 8 8 8 8 0 0 0 0 0 0 0 0 -16 0 0 0 0 -16 -16 -16 -16 -16 -16 -16 -16 -16 -16 -16 -16 -16 -16 -16 -16 -16 -16 0 0 0 0 0 0 0 0 0 0 0 0 0 0 0 0 0 0
278 8 8 8 8 8 8 8 8 8 8 8 8 8 8 0 0 0 0 0 0 0 0 -16 -16 0 0 0 -16 -16 -16 -16 -16 -16 -16 -16 -16 -16 -16 -16 -16 -16 -16 -16 -16 -16 0 0 0 0 0 0 0 0 0 0 0 0 0 0 0 0 0 0
289 8 8 8 8 8 8 8 8 8 8 8 8 8 0 0 0 0 0 0 0 0 0 -16 -16 0 0 0 -16 -16 -16 -16 -16 -16 -16 -16 -16 -16 -16 -16 -16 -16 -16 -16 -16 -16 0 0 0 0 0 0 0 0 0 0 0 0 0 0 0 0 0 0
297 8 8 8 8 8 8 8 8 8 8 8 8 8 0 0 0 0 0 0 0 0 0 -16 0 0 0 0 -16 -16 -16 -16 -16 -16 -16 -16 -16 -16 -16 -16 -16 -16 -16 -16 -16 -16 0 0 0 0 0 0 0 0 0 0 0 0 0 0 0 0 0 0
308 8 8 8 8 8 8 8 8 8 8 8 8 8 0 0 0 0 0 0 0 0 0 0 0 0 0 0 -16 -16 -16 -16 -16 -16 -16 -16 -16 -16 -16 -16 -16 -16 -16 -16 -16 -16 0 0 0 0 0 0 0 0 0 0 0 0 0 0 0 0 0 0
337 8 8 8 8 8 8 8 0 8 8 8 8 8 0 0 0 0 0 0 0 0 0 -16 0 0 0 0 -16 -16 -16 -16 -16 -16 -16 -16 -16 -16 -16 -16 -16 -16 -16 -16 -16 -16 0 0 0 0 0 0 0 0 0 0 0 0 0 0 0 0 0 0
343 8 8 8 8 8 8 8 0 0 8 8 8 8 0 0 0 0 0 0 0 0 0 -16 0 0 0 0 -16 -16 -16 -16 -16 -16 -16 -16 -16 -16 -16 -16 -16 -16 -16 -16 -16 -16 0 0 0 0 0 0 0 0 0 0 0 0 0 0 0 0 0 0
349 8 8 8 8 8 8 0 0 0 8 8 8 8 0 0 0 0 0 0 0 0 0 -16 0 0 0 0 -16 -16 -16 -16 -16 -16 -16 -16 -16 -16 -16 -16 -16 -16 -16 -16 -16 -16 0 0 0 0 0 0 0 0 0 0 0 0 0 0 0 0 0 0
360 8 8 8 8 8 8 0 0 0 8 8 8 8 0 0 0 0 0 0 0 0 0 0 0 0 0 0 -16 -16 -16 -16 -16 -16 -16 -16 -16 -16 -16 -16 -16 -16 -16 -16 -16 -16 0 0 0 0 0 0 0 0 0 0 0 0 0 0 0 0 0 0
373 8 8 8 8 8 8 0 0 0 8 8 8 8 8 0 0 0 0 0 0 0 0 0 0 0 0 0 -16 -16 -16 -16 -16 -16 -16 -16 -16 -16 -16 -16 -16 -16 -16 -16 -16 -16 0 0 0 0 0 0 0 0 0 0 0 0 0 0 0 0 0 0
439 8 8 8 8 8 8 8 0 0 8 8 8 8 8 0 0 0 0 0 0 0 0 0 0 0 0 0 -16 -16 -16 -16 -16 -16 -16 -16 -16 -16 -16 -16 -16 -16 -16 -16 -16 -16 0 0 0 0 0 0 0 0 0 0 0 0 0 0 0 0 0 0
441 8 8 8 8 8 8 8 8 8 8 8 8 8 8 0 0 8 8 0 0 0 0 0 0 0 0 0 -16 -16 -16 -16 -16 -16 -16 -16 -16 -16 -16 -16 -16 -16 -16 -16 -16 -16 0 0 0 0 0 0 0 0 0 0 0 0 0 0 0 0 0 0
460 8 8 8 8 8 8 8 8 8 8 8 8 8 8 0 8 8 8 0 0 0 0 0 0 0 0 0 -16 -16 -16 -16 -16 -16 -16 -16 -16 -16 -16 -16 -16 -16 -16 -16 -16 -16 0 0 0 0 0 0 0 0 0 0 0 0 0 0 0 0 0 0
470 8 8 8 8 8 8 8 8 8 8 8 8 8 8 0 8 8 8 0 0 8 0 0 0 0 0 0 -16 -16 -16 -16 -16 -16 -16 -16 -16 -16 -16 -16 -16 -16 -16 -16 -16 -16 0 0 0 0 0 0 0 0 0 0 0 0 0 0 0 0 0 0
472 8 8 8 8 8 8 8 8 8 8 8 8 8 8 0 8 8 8 0 0 8 0 0 0 0 8 0 -16 -16 -16 -16 -16 -16 -16 -16 -16 -16 -16 -16 -16 -16 -16 -16 -16 -16 0 0 0 0 0 0 0 0 0 0 0 0 0 0 0 0 0 0
475 8 8 8 8 8 8 8 8 8 8 8 8 8 8 0 8 8 8 0 0 8 0 0 0 0 8 8 -16 -16 -16 -16 -16 -16 -16 -16 -16 -16 -16 -16 -16 -16 -16 -16 -16 -16 0 0 0 0 0 0 0 0 0 0 0 0 0 0 0 0 0 0
484 8 8 8 8 8 8 8 8 8 8 8 8 8 8 0 8 8 8 0 8 8 0 0 0 0 8 8 -16 -16 -16 -16 -16 -16 -16 -16 -16 -16 -16 -16 -16 -16 -16 -16 -16 -16 0 0 0 0 0 0 0 0 0 0 0 0 0 0 0 0 0 0
488 8 8 8 8 8 8 8 8 8 8 8 8 8 8 0 8 8 8 0 8 8 8 0 0 0 8 8 -16 -16 -16 -16 -16 -16 -16 -16 -16 -16 -16 -16 -16 -16 -16 -16 -16 -16 0 0 0 0 0 0 0 0 0 0 0 0 0 0 0 0 0 0
489 8 8 8 8 8 8 8 8 8 8 8 8 8 8 0 8 8 8 0 8 8 0 0 0 0 8 8 -16 -16 -16 -16 -16 -16 -16 -16 -16 -16 -16 -16 -16 -16 -16 -16 -16 -16 0 0 0 0 0 0 0 0 0 0 0 0 0 0 0 0 0 0
492 8 8 8 8 8 8 8 8 8 8 8 8 8 8 0 8 8 8 0 8 8 0 0 0 0 0 0 -16 -16 -16 -16 -16 -16 -16 -16 -16 -16 -16 -16 -16 -16 -16 -16 -16 -16 0 0 0 0 0 0 0 0 0 0 0 0 0 0 0 0 0 0
496 8 8 8 8 8 8 8 8 8 8 8 8 8 8 0 8 8 8 0 0 8 0 0 0 0 0 0 -16 -16 -16 -16 -16 -16 -16 -16 -16 -16 -16 -16 -16 -16 -16 -16 -16 -16 0 0 0 0 0 0 0 0 0 0 0 0 0 0 0 0 0 0
497 8 8 8 8 8 8 8 8 8 8 8 8 8 8 0 8 8 8 0 0 0 0 0 0 0 0 0 -16 -16 -16 -16 -16 -16 -16 -16 -16 -16 -16 -16 -16 -16 -16 -16 -16 -16 0 0 0 0 0 0 0 0 0 0 0 0 0 0 0 0 0 0
508 8 8 8 8 8 8 8 8 8 8 8 8 8 8 8 8 8 8 0 0 0 0 0 0 0 0 0 -16 -16 -16 -16 -16 -16 -16 -16 -16 -16 -16 -16 -16 -16 -16 -16 -16 -16 0 0 0 0 0 0 0 0 0 0 0 0 0 0 0 0 0 0
524 8 8 8 8 8 8 8 8 8 8 8 8 8 8 8 8 8 8 0 0 0 0 0 0 0 8 0 -16 -16 -16 -16 -16 -16 -16 -16 -16 -16 -16 -16 -16 -16 -16 -16 -16 -16 0 0 0 0 0 0 0 0 0 0 0 0 0 0 0 0 0 0
526 8 8 8 8 8 8 8 8 8 8 8 8 8 8 8 8 8 8 0 0 0 0 0 0 0 8 8 -16 -16 -16 -16 -16 -16 -16 -16 -16 -16 -16 -16 -16 -16 -16 -16 -16 -16 0 0 0 0 0 0 0 0 0 0 0 0 0 0 0 0 0 0
528 8 8 8 8 8 8 8 8 8 8 8 8 8 8 8 8 8 8 0 0 0 0 0 0 8 8 8 -16 -16 -16 -16 -16 -16 -16 -16 -16 -16 -16 -16 -16 -16 -16 -16 -16 -16 0 0 0 0 0 0 0 0 0 0 0 0 0 0 0 0 0 0
530 8 8 8 8 8 8 8 8 8 8 8 8 8 8 8 8 8 8 0 0 0 0 0 0 0 8 8 -16 -16 -16 -16 -16 -16 -16 -16 -16 -16 -16 -16 -16 -16 -16 -16 -16 -16 0 0 0 0 0 0 0 0 0 0 0 0 0 0 0 0 0 0
532 8 8 8 8 8 8 8 8 8 8 8 8 8 8 8 8 8 8 0 0 0 0 0 0 0 8 0 -16 -16 -16 -16 -16 -16 -16 -16 -16 -16 -16 -16 -16 -16 -16 -16 -16 -16 0 0 0 0 0 0 0 0 0 0 0 0 0 0 0 0 0 0
533 8 8 8 8 8 8 8 8 8 8 8 8 8 8 8 8 8 8 0 0 0 0 0 0 0 0 0 -16 -16 -16 -16 -16 -16 -16 -16 -16 -16 -16 -16 -16 -16 -16 -16 -16 -16 0 0 0 0 0 0 0 0 0 0 0 0 0 0 0 0 0 0
535 8 8 8 8 8 8 8 8 8 8 8 8 8 8 8 8 8 0 0 0 0 0 0 0 0 0 0 -16 -16 -16 -16 -16 -16 -16 -16 -16 -16 -16 -16 -16 -16 -16 -16 -16 -16 0 0 0 0 0 0 0 0 0 0 0 0 0 0 0 0 0 0
536 8 8 8 8 8 8 8 0 0 8 8 8 8 8 8 0 0 0 0 0 0 0 0 0 0 0 0 -16 -16 -16 -16 -16 -16 -16 -16 -16 -16 -16 -16 -16 -16 -16 -16 -16 -16 0 0 0 0 0 0 0 0 0 0 0 0 0 0 0 0 0 0
538 8 8 8 8 8 8 0 0 0 8 8 8 8 8 8 0 0 0 0 0 0 0 0 0 0 0 0 -16 -16 -16 -16 -16 -16 -16 -16 -16 -16 -16 -16 -16 -16 -16 -16 -16 -16 0 0 0 0 0 0 0 0 0 0 0 0 0 0 0 0 0 0
539 8 8 8 8 8 8 0 0 0 8 8 8 8 8 0 0 0 0 0 0 0 0 0 0 0 0 0 -16 -16 -16 -16 -16 -16 -16 -16 -16 -16 -16 -16 -16 -16 -16 -16 -16 -16 0 0 0 0 0 0 0 0 0 0 0 0 0 0 0 0 0 0
561 8 8 8 8 8 8 8 0 0 8 8 8 8 8 0 0 0 0 0 0 0 0 0 0 0 0 0 -16 -16 -16 -16 -16 -16 -16 -16 -16 -16 -16 -16 -16 -16 -16 -16 -16 -16 0 0 0 0 0 0 0 0 0 0 0 0 0 0 0 0 0 0
563 8 8 8 8 8 8 8 8 8 8 8 8 8 8 0 0 8 8 0 0 0 0 0 0 0 0 0 -16 -16 -16 -16 -16 -16 -16 -16 -16 -16 -16 -16 -16 -16 -16 -16 -16 -16 0 0 0 0 0 0 0 0 0 0 0 0 0 0 0 0 0 0
564 8 8 8 8 8 8 8 8 8 8 8 8 8 8 0 8 8 8 0 0 0 0 0 0 0 0 0 -16 -16 -16 -16 -16 -16 -16 -16 -16 -16 -16 -16 -16 -16 -16 -16 -16 -16 0 0 0 0 0 0 0 0 0 0 0 0 0 0 0 0 0 0
587 8 8 8 8 8 8 8 8 8 8 8 8 8 8 0 0 8 8 0 0 0 0 0 0 0 0 0 -16 -16 -16 -16 -16 -16 -16 -16 -16 -16 -16 -16 -16 -16 -16 -16 -16 -16 0 0 0 0 0 0 0 0 0 0 0 0 0 0 0 0 0 0
614 8 8 8 8 8 8 8 8 8 8 8 8 8 8 0 0 8 8 0 8 0 0 0 0 0 0 0 -16 -16 -16 -16 -16 -16 -16 -16 -16 -16 -16 -16 -16 -16 -16 -16 -16 -16 0 0 0 0 0 0 0 0 0 0 0 0 0 0 0 0 0 0
623 8 8 8 8 8 8 8 8 8 8 8 8 8 8 8 0 8 8 0 8 0 0 0 0 0 0 0 -16 -16 -16 -16 -16 -16 -16 -16 -16 -16 -16 -16 -16 -16 -16 -16 -16 -16 0 0 0 0 0 0 0 0 0 0 0 0 0 0 0 0 0 0
626 8 8 8 8 8 8 8 8 8 8 8 8 8 8 8 0 8 8 0 8 8 0 0 0 0 0 0 -16 -16 -16 -16 -16 -16 -16 -16 -16 -16 -16 -16 -16 -16 -16 -16 -16 -16 0 0 0 0 0 0 0 0 0 0 0 0 0 0 0 0 0 0
630 8 8 8 8 8 8 8 8 8 8 8 8 8 8 8 8 8 8 0 8 8 0 0 0 0 0 0 -16 -16 -16 -16 -16 -16 -16 -16 -16 -16 -16 -16 -16 -16 -16 -16 -16 -16 0 0 0 0 0 0 0 0 0 0 0 0 0 0 0 0 0 0
640 8 8 8 8 8 8 8 8 8 8 8 8 8 8 8 8 8 8 0 0 8 0 0 0 0 0 0 -16 -16 -16 -16 -16 -16 -16 -16 -16 -16 -16 -16 -16 -16 -16 -16 -16 -16 0 0 0 0 0 0 0 0 0 0 0 0 0 0 0 0 0 0
641 8 8 8 8 8 8 8 8 8 8 8 8 8 8 8 8 8 8 0 0 0 0 0 0 0 0 0 -16 -16 -16 -16 -16 -16 -16 -16 -16 -16 -16 -16 -16 -16 -16 -16 -16 -16 0 0 0 0 0 0 0 0 0 0 0 0 0 0 0 0 0 0
657 8 8 8 8 8 8 0 0 0 8 8 8 8 8 8 8 8 8 0 0 0 0 0 0 0 0 0 -16 -16 -16 -16 -16 -16 -16 -16 -16 -16 -16 -16 -16 -16 -16 -16 -16 -16 0 0 0 0 0 0 0 0 0 0 0 0 0 0 0 0 0 0
658 8 8 8 8 8 0 0 0 0 8 8 8 8 8 0 0 0 0 0 0 0 0 0 0 0 0 0 -16 -16 -16 -16 -16 -16 -16 -16 -16 -16 -16 -16 -16 -16 -16 -16 -16 -16 0 0 0 0 0 0 0 0 0 0 0 0 0 0 0 0 0 0
666 8 8 8 8 8 0 0 0 0 8 8 8 8 0 0 0 0 0 0 0 0 0 0 0 0 0 0 -16 -16 -16 -16 -16 -16 -16 -16 -16 -16 -16 -16 -16 -16 -16 -16 -16 -16 0 0 0 0 0 0 0 0 0 0 0 0 0 0 0 0 0 0
676 8 8 8 8 8 0 0 0 0 8 8 8 8 8 0 0 0 0 0 0 0 0 0 0 0 0 0 -16 -16 -16 -16 -16 -16 -16 -16 -16 -16 -16 -16 -16 -16 -16 -16 -16 -16 0 0 0 0 0 0 0 0 0 0 0 0 0 0 0 0 0 0
685 8 8 8 8 8 8 8 8 8 8 8 8 8 8 8 8 8 8 0 0 0 0 0 0 0 0 8 -16 -16 -16 -16 -16 -16 -16 -16 -16 -16 -16 -16 -16 -16 -16 -16 -16 -16 0 0 0 0 0 0 0 0 0 0 0 0 0 0 0 0 0 0
686 8 8 8 8 8 8 8 8 8 8 8 8 8 8 8 8 8 8 0 0 0 0 0 0 0 8 8 -16 -16 -16 -16 -16 -16 -16 -16 -16 -16 -16 -16 -16 -16 -16 -16 -16 -16 0 0 0 0 0 0 0 0 0 0 0 0 0 0 0 0 0 0
688 8 8 8 8 8 8 8 8 8 8 8 8 8 8 8 8 8 8 0 0 0 0 0 0 8 8 8 -16 -16 -16 -16 -16 -16 -16 -16 -16 -16 -16 -16 -16 -16 -16 -16 -16 -16 0 0 0 0 0 0 0 0 0 0 0 0 0 0 0 0 0 0
690 8 8 8 8 8 8 8 8 8 8 8 8 8 8 8 8 8 8 0 0 0 0 0 8 8 8 8 -16 -16 -16 -16 -16 -16 -16 -16 -16 -16 -16 -16 -16 -16 -16 -16 -16 -16 0 0 0 0 0 0 0 0 0 0 0 0 0 0 0 0 0 0
692 8 8 8 8 8 8 8 8 8 8 8 8 8 8 8 8 8 8 0 0 0 0 0 0 8 8 8 -16 -16 -16 -16 -16 -16 -16 -16 -16 -16 -16 -16 -16 -16 -16 -16 -16 -16 0 0 0 0 0 0 0 0 0 0 0 0 0 0 0 0 0 0
695 8 8 8 8 8 8 8 8 8 8 8 8 8 8 8 8 8 8 0 0 0 0 0 0 0 8 8 -16 -16 -16 -16 -16 -16 -16 -16 -16 -16 -16 -16 -16 -16 -16 -16 -16 -16 0 0 0 0 0 0 0 0 0 0 0 0 0 0 0 0 0 0
697 8 8 8 8 8 8 8 8 8 8 8 8 8 8 8 8 8 8 0 0 0 0 0 0 0 0 8 -16 -16 -16 -16 -16 -16 -16 -16 -16 -16 -16 -16 -16 -16 -16 -16 -16 -16 0 0 0 0 0 0 0 0 0 0 0 0 0 0 0 0 0 0
698 8 8 8 8 8 8 0 0 0 8 8 8 8 8 0 0 0 0 0 0 0 0 0 0 0 0 0 -16 -16 -16 -16 -16 -16 -16 -16 -16 -16 -16 -16 -16 -16 -16 -16 -16 -16 0 0 0 0 0 0 0 0 0 0 0 0 0 0 0 0 0 0
699 8 8 8 8 8 8 0 0 0 8 8 8 8 8 0 0 0 0 0 0 0 8 0 0 0 0 0 -16 -16 -16 -16 -16 -16 -16 -16 -16 -16 -16 -16 -16 -16 -16 -16 -16 -16 0 0 0 0 0 0 0 0 0 0 0 0 0 0 0 0 0 0
711 8 8 8 8 8 0 0 0 0 8 8 8 8 8 0 0 0 0 0 0 0 8 0 0 0 0 0 -16 -16 -16 -16 -16 -16 -16 -16 -16 -16 -16 -16 -16 -16 -16 -16 -16 -16 0 0 0 0 0 0 0 0 0 0 0 0 0 0 0 0 0 0
720 8 8 8 8 8 0 0 0 0 8 8 8 8 0 0 0 0 0 0 0 0 8 0 0 0 0 0 -16 -16 -16 -16 -16 -16 -16 -16 -16 -16 -16 -16 -16 -16 -16 -16 -16 -16 0 0 0 0 0 0 0 0 0 0 0 0 0 0 0 0 0 0
727 8 8 8 8 8 0 0 0 0 8 8 8 8 0 0 0 0 0 0 0 8 8 0 0 0 0 0 -16 -16 -16 -16 -16 -16 -16 -16 -16 -16 -16 -16 -16 -16 -16 -16 -16 -16 0 0 0 0 0 0 0 0 0 0 0 0 0 0 0 0 0 0
739 8 8 8 8 8 0 0 0 0 8 8 8 8 8 0 0 0 0 0 0 8 8 0 0 0 0 0 -16 -16 -16 -16 -16 -16 -16 -16 -16 -16 -16 -16 -16 -16 -16 -16 -16 -16 0 0 0 0 0 0 0 0 0 0 0 0 0 0 0 0 0 0
741 8 8 8 8 8 8 0 0 0 8 8 8 8 8 0 0 0 0 0 0 8 8 0 0 0 0 0 -16 -16 -16 -16 -16 -16 -16 -16 -16 -16 -16 -16 -16 -16 -16 -16 -16 -16 0 0 0 0 0 0 0 0 0 0 0 0 0 0 0 0 0 0
746 8 8 8 8 8 8 8 8 8 8 8 8 8 8 8 8 8 8 0 0 8 8 0 0 0 8 8 -16 -16 -16 -16 -16 -16 -16 -16 -16 -16 -16 -16 -16 -16 -16 -16 -16 -16 0 0 0 0 0 0 0 0 0 0 0 0 0 0 0 0 0 0
747 8 8 8 8 8 8 8 8 8 8 8 8 8 8 8 8 8 8 0 0 8 8 0 0 8 8 8 -16 -16 -16 -16 -16 -16 -16 -16 -16 -16 -16 -16 -16 -16 -16 -16 -16 -16 0 0 0 0 0 0 0 0 0 0 0 0 0 0 0 0 0 0
749 8 8 8 8 8 8 8 8 8 8 8 8 8 8 8 8 8 8 0 0 8 8 0 8 8 8 8 -16 -16 -16 -16 -16 -16 -16 -16 -16 -16 -16 -16 -16 -16 -16 -16 -16 -16 0 0 0 0 0 0 0 0 0 0 0 0 0 0 0 0 0 0
752 8 8 8 8 8 8 8 8 8 8 8 8 8 8 8 8 8 8 0 0 8 8 8 8 8 8 8 -16 -16 -16 -16 -16 -16 -16 -16 -16 -16 -16 -16 -16 -16 -16 -16 -16 -16 0 0 0 0 0 0 0 0 0 0 0 0 0 0 0 0 0 0
753 8 8 8 8 8 8 8 8 8 8 8 8 8 8 8 8 8 8 0 0 8 8 0 8 8 8 8 -16 -16 -16 -16 -16 -16 -16 -16 -16 -16 -16 -16 -16 -16 -16 -16 -16 -16 0 0 0 0 0 0 0 0 0 0 0 0 0 0 0 0 0 0
755 8 8 8 8 8 8 8 8 8 8 8 8 8 8 8 8 8 8 0 0 8 8 0 0 8 8 8 -16 -16 -16 -16 -16 -16 -16 -16 -16 -16 -16 -16 -16 -16 -16 -16 -16 -16 0 0 0 0 0 0 0 0 0 0 0 0 0 0 0 0 0 0
758 8 8 8 8 8 8 8 8 8 8 8 8 8 8 8 8 8 8 0 8 8 8 0 0 0 8 8 -16 -16 -16 -16 -16 -16 -16 -16 -16 -16 -16 -16 -16 -16 -16 -16 -16 -16 0 0 0 0 0 0 0 0 0 0 0 0 0 0 0 0 0 0
759 8 8 8 8 8 8 0 0 0 8 8 8 8 8 0 0 0 0 0 8 8 8 0 0 0 0 0 -16 -16 -16 -16 -16 -16 -16 -16 -16 -16 -16 -16 -16 -16 -16 -16 -16 -16 0 0 0 0 0 0 0 0 0 0 0 0 0 0 0 0 0 0
767 8 8 8 8 8 0 0 0 0 8 8 8 8 8 0 0 0 0 0 8 8 8 0 0 0 0 0 -16 -16 -16 -16 -16 -16 -16 -16 -16 -16 -16 -16 -16 -16 -16 -16 -16 -16 0 0 0 0 0 0 0 0 0 0 0 0 0 0 0 0 0 0
778 8 8 8 8 8 8 0 0 0 8 8 8 8 8 0 0 0 0 0 8 8 8 0 0 0 0 0 -16 -16 -16 -16 -16 -16 -16 -16 -16 -16 -16 -16 -16 -16 -16 -16 -16 -16 0 0 0 0 0 0 0 0 0 0 0 0 0 0 0 0 0 0
780 8 8 8 8 8 8 0 0 0 8 8 8 8 8 0 0 0 0 8 8 8 8 0 0 0 0 0 -16 -16 -16 -16 -16 -16 -16 -16 -16 -16 -16 -16 -16 -16 -16 -16 -16 -16 0 0 0 0 0 0 0 0 0 0 0 0 0 0 0 0 0 0
786 8 8 8 8 8 8 8 8 8 8 8 8 8 8 0 8 8 8 8 8 8 8 0 0 0 0 0 -16 -16 -16 -16 -16 -16 -16 -16 -16 -16 -16 -16 -16 -16 -16 -16 -16 -16 0 0 0 0 0 0 0 0 0 0 0 0 0 0 0 0 0 0
787 8 8 8 8 8 8 8 8 8 8 8 8 8 8 8 8 8 8 8 8 8 8 0 0 0 0 0 -16 -16 -16 -16 -16 -16 -16 -16 -16 -16 -16 -16 -16 -16 -16 -16 -16 -16 0 0 0 0 0 0 0 0 0 0 0 0 0 0 0 0 0 0
788 8 8 8 8 8 8 8 8 8 8 8 8 8 8 8 8 8 8 8 8 8 8 0 0 0 8 0 -16 -16 -16 -16 -16 -16 -16 -16 -16 -16 -16 -16 -16 -16 -16 -16 -16 -16 0 0 0 0 0 0 0 0 0 0 0 0 0 0 0 0 0 0
789 8 8 8 8 8 8 8 8 8 8 8 8 8 8 8 8 8 8 8 8 8 8 0 0 0 8 8 -16 -16 -16 -16 -16 -16 -16 -16 -16 -16 -16 -16 -16 -16 -16 -16 -16 -16 0 0 0 0 0 0 0 0 0 0 0 0 0 0 0 0 0 0
803 8 8 8 8 8 8 8 8 8 8 8 8 8 8 8 8 8 8 8 8 8 0 0 0 0 8 8 -16 -16 -16 -16 -16 -16 -16 -16 -16 -16 -16 -16 -16 -16 -16 -16 -16 -16 0 0 0 0 0 0 0 0 0 0 0 0 0 0 0 0 0 0
804 8 8 8 8 8 8 8 8 8 8 8 8 8 8 8 8 8 8 8 8 0 0 0 0 0 8 8 -16 -16 -16 -16 -16 -16 -16 -16 -16 -16 -16 -16 -16 -16 -16 -16 -16 -16 0 0 0 0 0 0 0 0 0 0 0 0 0 0 0 0 0 0
814 8 8 8 8 8 8 8 8 8 8 8 8 8 8 8 8 8 8 8 0 0 0 0 0 0 8 8 -16 -16 -16 -16 -16 -16 -16 -16 -16 -16 -16 -16 -16 -16 -16 -16 -16 -16 0 0 0 0 0 0 0 0 0 0 0 0 0 0 0 0 0 0
820 8 8 8 8 8 8 8 8 8 8 8 8 8 8 8 8 8 8 0 0 0 0 0 0 0 8 8 -16 -16 -16 -16 -16 -16 -16 -16 -16 -16 -16 -16 -16 -16 -16 -16 -16 -16 0 0 0 0 0 0 0 0 0 0 0 0 0 0 0 0 0 0
864 8 8 8 8 8 8 8 8 8 8 8 8 8 8 8 8 8 8 0 0 0 0 0 0 0 0 8 -16 -16 -16 -16 -16 -16 -16 -16 -16 -16 -16 -16 -16 -16 -16 -16 -16 -16 0 0 0 0 0 0 0 0 0 0 0 0 0 0 0 0 0 0
877 8 8 8 8 8 8 8 8 8 8 8 8 8 8 8 8 8 8 0 0 0 0 0 0 0 0 0 -16 -16 -16 -16 -16 -16 -16 -16 -16 -16 -16 -16 -16 -16 -16 -16 -16 -16 0 0 0 0 0 0 0 0 0 0 0 0 0 0 0 0 0 0
881 8 8 8 8 8 8 8 8 8 8 8 8 8 8 8 0 8 8 0 0 0 0 0 0 0 0 0 -16 -16 -16 -16 -16 -16 -16 -16 -16 -16 -16 -16 -16 -16 -16 -16 -16 -16 0 0 0 0 0 0 0 0 0 0 0 0 0 0 0 0 0 0
892 8 8 8 8 8 8 8 8 8 8 8 8 8 8 8 0 8 8 0 0 0 0 0 0 0 0 0 0 -16 -16 -16 -16 -16 -16 -16 -16 -16 -16 -16 -16 -16 -16 -16 -16 -16 0 0 0 0 0 0 0 0 0 0 0 0 0 0 0 0 0 0
893 8 8 8 8 8 8 8 8 8 8 8 8 8 8 8 0 8 8 0 0 0 0 0 0 0 0 0 0 -16 -16 -16 -16 -16 -16 -16 0 -16 -16 -16 -16 -16 -16 -16 -16 -16 0 0 0 0 0 0 0 0 0 0 0 0 0 0 0 0 0 0
894 8 8 8 8 8 8 8 8 8 8 8 8 8 8 8 0 0 8 0 0 0 0 0 0 0 0 0 0 -16 -16 -16 -16 -16 -16 -16 0 -16 -16 -16 -16 -16 -16 -16 -16 -16 0 0 0 0 0 0 0 0 0 0 0 0 0 0 0 0 0 0
896 8 8 8 8 8 8 8 8 8 8 8 8 8 8 8 0 0 8 0 0 0 0 0 0 0 0 0 0 -16 -16 -16 -16 -16 -16 -16 -16 -16 -16 -16 -16 -16 -16 -16 -16 -16 0 0 0 0 0 0 0 0 0 0 0 0 0 0 0 0 0 0
897 8 8 8 8 8 8 8 8 8 8 8 8 8 8 8 0 0 8 0 0 0 0 0 0 0 0 0 -16 -16 -16 -16 -16 -16 -16 -16 -16 -16 -16 -16 -16 -16 -16 -16 -16 -16 0 0 0 0 0 0 0 0 0 0 0 0 0 0 0 0 0 0
910 8 8 8 8 8 8 8 8 8 8 8 8 8 8 8 0 0 8 0 0 0 0 0 0 0 -16 -16 -16 -16 -16 -16 -16 -16 -16 -16 -16 -16 -16 -16 -16 -16 -16 -16 -16 -16 0 0 0 0 0 0 0 0 0 0 0 0 0 0 0 0 0 0
921 8 8 8 8 8 8 8 8 8 8 8 8 8 8 8 0 0 0 0 0 0 0 0 0 0 0 -16 -16 -16 -16 -16 -16 -16 -16 -16 -16 -16 -16 -16 -16 -16 -16 -16 -16 -16 0 0 0 0 0 0 0 0 0 0 0 0 0 0 0 0 0 0
938 8 8 8 8 8 8 8 8 8 8 8 8 8 8 8 0 0 0 0 0 0 0 0 0 0 0 0 -16 -16 -16 -16 -16 -16 -16 -16 -16 -16 -16 -16 -16 -16 -16 -16 -16 -16 0 0 0 0 0 0 0 0 0 0 0 0 0 0 0 0 0 0
941 8 8 8 8 8 8 8 0 8 8 8 8 8 8 8 0 0 0 0 0 0 0 0 0 0 0 0 -16 -16 -16 -16 -16 -16 -16 -16 -16 -16 -16 -16 -16 -16 -16 -16 -16 -16 0 0 0 0 0 0 0 0 0 0 0 0 0 0 0 0 0 0
942 8 8 8 8 8 8 8 0 0 8 8 8 8 8 8 0 0 0 0 0 0 0 0 0 0 0 0 -16 -16 -16 -16 -16 -16 -16 -16 -16 -16 -16 -16 -16 -16 -16 -16 -16 -16 0 0 0 0 0 0 0 0 0 0 0 0 0 0 0 0 0 0
969 8 8 8 8 8 8 8 8 8 8 8 8 8 8 8 0 0 0 0 0 0 0 0 0 0 0 0 -16 -16 -16 -16 -16 -16 -16 -16 -16 -16 -16 -16 -16 -16 -16 -16 -16 -16 0 0 0 0 0 0 0 0 0 0 0 0 0 0 0 0 0 0
970 8 8 8 8 8 8 8 8 8 8 8 8 8 8 8 0 0 8 0 0 0 0 0 0 0 0 0 -16 -16 -16 -16 -16 -16 -16 -16 -16 -16 -16 -16 -16 -16 -16 -16 -16 -16 0 0 0 0 0 0 0 0 0 0 0 0 0 0 0 0 0 0
983 8 8 8 8 8 8 8 8 8 8 8 8 8 8 0 0 0 8 0 0 0 0 0 0 0 0 0 -16 -16 -16 -16 -16 -16 -16 -16 -16 -16 -16 -16 -16 -16 -16 -16 -16 -16 0 0 0 0 0 0 0 0 0 0 0 0 0 0 0 0 0 0
990 8 8 8 8 8 8 8 8 8 8 8 8 8 8 0 0 0 0 0 0 0 0 0 0 0 0 0 -16 -16 -16 -16 -16 -16 -16 -16 -16 -16 -16 -16 -16 -16 -16 -16 -16 -16 0 0 0 0 0 0 0 0 0 0 0 0 0 0 0 0 0 0
1017 8 8 8 8 8 8 8 8 8 8 8 8 8 0 0 0 0 0 0 0 0 0 0 0 0 0 0 -16 -16 -16 -16 -16 -16 -16 -16 -16 -16 -16 -16 -16 -16 -16 -16 -16 -16 0 0 0 0 0 0 0 0 0 0 0 0 0 0 0 0 0 0
1020 8 8 8 8 8 8 8 8 8 8 8 8 8 0 0 0 8 0 0 0 0 0 0 0 0 0 0 -16 -16 -16 -16 -16 -16 -16 -16 -16 -16 -16 -16 -16 -16 -16 -16 -16 -16 0 0 0 0 0 0 0 0 0 0 0 0 0 0 0 0 0 0
1022 8 8 8 8 8 8 8 8 8 8 8 8 8 0 0 0 8 8 0 0 0 0 0 0 0 0 0 -16 -16 -16 -16 -16 -16 -16 -16 -16 -16 -16 -16 -16 -16 -16 -16 -16 -16 0 0 0 0 0 0 0 0 0 0 0 0 0 0 0 0 0 0
1029 8 8 8 8 8 8 8 8 8 8 8 8 0 0 0 0 8 8 0 0 0 0 0 0 0 0 0 -16 -16 -16 -16 -16 -16 -16 -16 -16 -16 -16 -16 -16 -16 -16 -16 -16 -16 0 0 0 0 0 0 0 0 0 0 0 0 0 0 0 0 0 0
1031 8 8 8 8 8 8 8 8 8 8 8 0 0 0 0 0 8 8 0 0 0 0 0 0 0 0 0 -16 -16 -16 -16 -16 -16 -16 -16 -16 -16 -16 -16 -16 -16 -16 -16 -16 -16 0 0 0 0 0 0 0 0 0 0 0 0 0 0 0 0 0 0
1041 8 8 8 8 8 8 8 8 8 8 8 0 8 8 0 0 0 8 0 0 0 0 0 0 0 0 0 -16 -16 -16 -16 -16 -16 -16 -16 -16 -16 -16 -16 -16 -16 -16 -16 -16 -16 0 0 0 0 0 0 0 0 0 0 0 0 0 0 0 0 0 0
1042 8 8 8 8 8 8 8 8 8 8 8 0 8 8 0 0 0 0 0 0 0 0 0 0 0 0 0 -16 -16 -16 -16 -16 -16 -16 -16 -16 -16 -16 -16 -16 -16 -16 -16 -16 -16 0 0 0 0 0 0 0 0 0 0 0 0 0 0 0 0 0 0
1043 8 8 8 8 8 8 8 8 0 8 8 8 8 8 0 0 0 0 0 0 0 0 0 0 0 0 0 -16 -16 -16 -16 -16 -16 -16 -16 -16 -16 -16 -16 -16 -16 -16 -16 -16 -16 0 0 0 0 0 0 0 0 0 0 0 0 0 0 0 0 0 0
1044 8 8 8 8 8 8 0 0 0 8 8 8 8 8 0 0 0 0 0 0 0 0 0 0 0 0 0 -16 -16 -16 -16 -16 -16 -16 -16 -16 -16 -16 -16 -16 -16 -16 -16 -16 -16 0 0 0 0 0 0 0 0 0 0 0 0 0 0 0 0 0 0
1076 8 8 8 8 8 0 0 0 0 8 8 8 8 8 0 0 0 0 0 0 0 0 0 0 0 0 0 -16 -16 -16 -16 -16 -16 -16 -16 -16 -16 -16 -16 -16 -16 -16 -16 -16 -16 0 0 0 0 0 0 0 0 0 0 0 0 0 0 0 0 0 0
1079 8 8 8 8 8 8 0 0 0 8 8 8 8 8 0 0 0 0 0 0 0 0 0 0 0 0 0 -16 -16 -16 -16 -16 -16 -16 -16 -16 -16 -16 -16 -16 -16 -16 -16 -16 -16 0 0 0 0 0 0 0 0 0 0 0 0 0 0 0 0 0 0
1087 8 8 8 8 8 8 0 0 0 8 8 8 8 8 0 0 0 0 0 0 0 0 0 -16 0 0 0 -16 -16 -16 -16 -16 -16 -16 -16 -16 -16 -16 -16 -16 -16 -16 -16 -16 -16 0 0 0 0 0 0 0 0 0 0 0 0 0 0 0 0 0 0
1091 8 8 8 8 8 8 8 8 8 8 8 8 8 8 0 0 0 8 0 0 0 0 0 -16 0 0 0 -16 -16 -16 -16 -16 -16 -16 -16 -16 -16 -16 -16 -16 -16 -16 -16 -16 -16 0 0 0 0 0 0 0 0 0 0 0 0 0 0 0 0 0 0
1092 8 8 8 8 8 8 8 8 8 8 8 8 8 8 0 0 8 8 0 0 0 0 0 -16 0 0 0 -16 -16 -16 -16 -16 -16 -16 -16 -16 -16 -16 -16 -16 -16 -16 -16 -16 -16 0 0 0 0 0 0 0 0 0 0 0 0 0 0 0 0 0 0
1103 8 8 8 8 8 8 8 8 8 8 8 8 8 8 0 0 0 8 0 0 0 0 0 -16 0 0 0 -16 -16 -16 -16 -16 -16 -16 -16 -16 -16 -16 -16 -16 -16 -16 -16 -16 -16 0 0 0 0 0 0 0 0 0 0 0 0 0 0 0 0 0 0
1104 8 8 8 8 8 8 8 8 8 8 8 8 8 8 0 0 0 0 0 0 0 0 0 -16 0 0 0 -16 -16 -16 -16 -16 -16 -16 -16 -16 -16 -16 -16 -16 -16 -16 -16 -16 -16 0 0 0 0 0 0 0 0 0 0 0 0 0 0 0 0 0 0
1105 8 8 8 8 8 8 8 0 0 8 8 8 8 8 0 0 0 0 0 0 0 0 0 -16 0 0 0 -16 -16 -16 -16 -16 -16 -16 -16 -16 -16 -16 -16 -16 -16 -16 -16 -16 -16 0 0 0 0 0 0 0 0 0 0 0 0 0 0 0 0 0 0
1106 8 8 8 8 8 8 8 0 0 8 8 8 8 8 0 0 0 0 0 0 0 0 0 0 0 0 0 -16 -16 -16 -16 -16 -16 -16 -16 -16 -16 -16 -16 -16 -16 -16 -16 -16 -16 0 0 0 0 0 0 0 0 0 0 0 0 0 0 0 0 0 0
1112 8 8 8 8 8 8 0 0 0 8 8 8 8 8 0 0 0 0 0 0 0 0 0 0 0 0 0 -16 -16 -16 -16 -16 -16 -16 -16 -16 -16 -16 -16 -16 -16 -16 -16 -16 -16 0 0 0 0 0 0 0 0 0 0 0 0 0 0 0 0 0 0
1129 8 8 8 8 8 0 0 0 0 8 8 8 8 8 0 0 0 0 0 0 0 0 0 0 0 0 0 -16 -16 -16 -16 -16 -16 -16 -16 -16 -16 -16 -16 -16 -16 -16 -16 -16 -16 0 0 0 0 0 0 0 0 0 0 0 0 0 0 0 0 0 0
1151 8 8 8 8 8 8 0 0 0 8 8 8 8 8 0 0 0 0 0 0 0 0 0 0 0 0 0 -16 -16 -16 -16 -16 -16 -16 -16 -16 -16 -16 -16 -16 -16 -16 -16 -16 -16 0 0 0 0 0 0 0 0 0 0 0 0 0 0 0 0 0 0
1152 8 8 8 8 8 8 0 8 8 8 8 8 8 8 0 0 0 8 0 0 0 0 0 0 0 0 0 -16 -16 -16 -16 -16 -16 -16 -16 -16 -16 -16 -16 -16 -16 -16 -16 -16 -16 0 0 0 0 0 0 0 0 0 0 0 0 0 0 0 0 0 0
1157 8 8 8 8 8 8 8 8 8 8 8 8 8 8 0 0 8 8 0 0 0 0 0 0 0 0 0 -16 -16 -16 -16 -16 -16 -16 -16 -16 -16 -16 -16 -16 -16 -16 -16 -16 -16 0 0 0 0 0 0 0 0 0 0 0 0 0 0 0 0 0 0
1160 8 8 8 8 8 8 0 8 8 8 8 8 8 8 0 0 8 8 0 0 0 0 0 0 0 0 0 -16 -16 -16 -16 -16 -16 -16 -16 -16 -16 -16 -16 -16 -16 -16 -16 -16 -16 0 0 0 0 0 0 0 0 0 0 0 0 0 0 0 0 0 0
1161 8 8 8 8 8 8 0 8 8 8 8 8 8 8 0 0 0 8 0 0 0 0 0 0 0 0 0 -16 -16 -16 -16 -16 -16 -16 -16 -16 -16 -16 -16 -16 -16 -16 -16 -16 -16 0 0 0 0 0 0 0 0 0 0 0 0 0 0 0 0 0 0
1165 8 8 8 8 8 0 0 8 0 8 8 8 8 8 0 0 0 0 0 0 0 0 0 0 0 0 0 -16 -16 -16 -16 -16 -16 -16 -16 -16 -16 -16 -16 -16 -16 -16 -16 -16 -16 0 0 0 0 0 0 0 0 0 0 0 0 0 0 0 0 0 0
1166 8 8 8 8 8 0 0 0 0 8 8 8 8 8 0 0 0 0 0 0 0 0 0 0 0 0 0 -16 -16 -16 -16 -16 -16 -16 -16 -16 -16 -16 -16 -16 -16 -16 -16 -16 -16 0 0 0 0 0 0 0 0 0 0 0 0 0 0 0 0 0 0
1180 8 8 8 8 8 0 0 0 0 8 8 8 8 8 0 0 0 0 0 0 0 0 0 0 0 -16 -16 -16 -16 -16 -16 -16 -16 -16 -16 -16 -16 -16 -16 -16 -16 -16 -16 -16 -16 0 0 0 0 0 0 0 0 0 0 0 0 0 0 0 0 0 0
1190 8 8 8 8 8 8 0 0 0 8 8 8 8 8 0 0 0 0 0 0 0 0 0 0 0 -16 -16 -16 -16 -16 -16 -16 -16 -16 -16 -16 -16 -16 -16 -16 -16 -16 -16 -16 -16 0 0 0 0 0 0 0 0 0 0 0 0 0 0 0 0 0 0
1193 8 8 8 8 8 8 8 8 8 8 8 8 8 8 0 0 0 0 0 0 0 0 0 0 0 -16 -16 -16 -16 -16 -16 -16 -16 -16 -16 -16 -16 -16 -16 -16 -16 -16 -16 -16 -16 0 0 0 0 0 0 0 0 0 0 0 0 0 0 0 0 0 0
1198 8 8 8 8 8 8 8 8 8 8 8 8 8 8 0 0 8 0 0 0 0 0 0 0 0 -16 -16 -16 -16 -16 -16 -16 -16 -16 -16 -16 -16 -16 -16 -16 -16 -16 -16 -16 -16 0 0 0 0 0 0 0 0 0 0 0 0 0 0 0 0 0 0
1199 8 8 8 8 8 8 8 8 8 8 8 8 8 8 0 0 8 8 0 0 0 0 0 0 0 -16 -16 -16 -16 -16 -16 -16 -16 -16 -16 -16 -16 -16 -16 -16 -16 -16 -16 -16 -16 0 0 0 0 0 0 0 0 0 0 0 0 0 0 0 0 0 0
